NN_bacterium	JJ_bacterial
NN_lam	NP_lam
JJ_acid	NN_acid
JJ_alternative	NN_alternative
NN_angstrom	angstrom
NN_b	NP_b
NN_bacterium	JJ_bacterial
JJ_beta	NN_beta
JJ_binding NN_site	VV_bind NN_site
JJ_binding	VV_bind
NN_cell	cells
JJ_chemical	NN_chemical
NN_algae	algae
JJ_blue-green	NP_blue-green
JJ_blue-green NN_algae	NP_blue-green algae
JJ_blue-green NN_algae	blue-green-algae
NP_blue-green algae	blue-green-algae
JJ_brown NN_alga	JJ_brown NN_algae
NN_algae	NN_alga
cyanobacteria	cyanobacterial
JJ_delta	NN_delta
JJ_delta	NP_delta
JJ_green	NP_green
JJ_green NN_alga	JJ_green NN_algae
NN_algae	NN_alga
JJ_green NN_alga	NP_green algae
JJ_green NN_algae	NP_green algae
JJ_green NN_algae	green-algae
NP_green algae	green-algae
JJ_juvenile	NN_juvenile
NN_lake	NP_lake
macroalga	macroalgae
macroalga	macroalgal
macroalgae	macroalgal
macrophyte	macrophytes
JJ_marine	NP_marine
microalgae	microalgal
microcystin	microcystins
microcystin	microcystis
microcystins	microcystis
photosystem PP_i	photosystem NP_ii
PP_i	NP_ii
JJ_red NN_alga	JJ_red NN_algae
NN_algae	NN_alga
NN_river	NP_river
NN_substratum	NN_substrate
JJ_unicellular JJ_green NN_alga	JJ_unicellular JJ_green NN_algae
NN_algae	NN_alga
JJ_constant	NN_constant
JJ_core	NN_core
NN_culture	JJ_cultured
JJ_current	NN_current
NN_datum NN_set	NN_datum VV_set
NN_set	VV_set
NN_delta	NP_delta
NN_dna VV_bind	dna-binding
JJ_dynamic	NN_dynamics
NN_e	NP_e
JJ_enhanced	NN_enhancer
NN_feedback	feedback
JJ_folding	NN_folding
NN_gene	NP_gene
NN_gene JJ_regulatory NN_network	JJ_genetic JJ_regulatory NN_network
JJ_genetic	NN_gene
genomic	genomics
NN_h	NP_h
NN_homolog	NN_homology
JJ_human	NP_human
NN_hydrogen NN_bond NN_network	NN_hydrogen VV_bond NN_network
NN_bond	VV_bond
NP_ii	ii
NP_iii	iii
NN_inhibitor	JJ_inhibitory
JJ_intermediate	NN_intermediate
NN_k	NP_k
NN_kappa NN_b	NN_kappa NP_b
NP_b	NN_b
JJ_kinetic	NN_kinetics
JJ_light	NN_light
JJ_mass	NN_mass
NN_mitochondrion	JJ_mitochondrial
NN_n	NP_n
NN_network	NP_network
NN_network	NP_networks
NP_network	NP_networks
NN_r	NP_r
NN_regulator	JJ_regulatory
NN_science	NP_science
tgf NN_beta	tgf-beta
NN_transcription	JJ_transcriptional
NN_type NP_ii	NN_type NP_iii
NP_ii	NP_iii
JJ_vertebrate	NN_vertebrate
NP_vitro	vitro
JJ_wild NN_type	wild-type
NN_business NN_planning	NN_business VV_plan
NN_planning	VV_plan
NN_business VV_plan	NP_business NP_planning
NN_care	NP_care
NN_company	companys
JJ_financial NN_modeling	JJ_financial VV_model
VV_model	NN_modeling
NP_planning NN_analyst	VV_plan NN_analyst
VV_plan	NP_planning
NP_planning NP_analyst	VV_plan NN_analyst
NN_planning NN_process	VV_plan NN_process
NN_planning	VV_plan
NN_range NN_planning	NN_range VV_plan
NN_planning	VV_plan
NN_staff	NP_staff
JJ_strategic NN_planning	JJ_strategic VV_plan
NN_planning	VV_plan
JJ_strategic VV_plan	NP_strategic NP_planning
NN_treasury	NP_treasury
mass-spectrometry	NN_mass NN_spectrometry
pharmacokinetic	pharmacokinetics
dna	NN_dna
NN_bacillus thuringiensis	bacillus-thuringiensis
NN_species	NN_specie
escherichia NN_coli	escherichia-coli
NN_gene NN_expression	gene-expression
NN_behaviour	NN_behavior
JJ_novel NN_food	NN_novel NN_food
NN_mycotoxin	mycotoxin
NN_rat	rats
probiotic	probiotics
JJ_lactic NN_acid	lactic-acid
NN_means	NN_mean
NN_lung-cancer	NN_lung NN_cancer
NN_phase	phase
ms	NN_ms
enterotoxin	enterotoxins
NP_drug NP_administration NN_approval	NP_drug administration-approved
NP_drug NP_administration	NN_drug NN_administration
NN_data	NN_datum
JJ_animal NN_model	NN_animal NN_model
NN_toxicology	toxicology
NN_novel NN_approach	JJ_novel NN_approach
NN_characterization	NN_characterisation
NN_body NN_weight	body-weight
NN_heavy-metal	JJ_heavy NN_metal
NN_breast-cancer	NN_breast NN_cancer
NP_administration NN_approval	administration-approved
saccharomyces-cerevisiae	saccharomyces cerevisiae
gel-electrophoresis	NN_gel electrophoresis
phase-i	phase-ii
NN_high-dose	JJ_high NN_dose
JJ_human CC_and JJ_animal	NN_human CC_and NN_animal
NP_united NP_states	united-states
NN_low-dose	JJ_low NN_dose
NN_risk-assessment	NN_risk NN_assessment
phase-i NN_trial	phase-ii NN_trial
toxicity	NN_toxicity
NN_tree NN_specie	NN_tree NN_species
macroinvertebrate	macroinvertebrates
NN_specie NN_diversity	NN_species NN_diversity
JJ_new NN_species	JJ_new NN_specie
NN_rainforest	NN_rain NN_forest
JJ_national NN_park	NP_national NP_park
NN_ecosystem	ecosystem
understory	understorey
NN_plant NN_species NN_richness	NN_plant NN_specie NN_richness
NN_plant NN_specie	NN_plant NN_species
dataset	datasets
NN_region	region
NN_species NN_richness	NP_species NN_richness
NN_species NN_richness	NN_specie NN_richness
NN_land-use	NN_land NN_use
biodiversity NN_hotspot	biodiversity hotspot
NN_diversity	diversity
NP_biological diversity	JJ_biological NN_diversity
NN_species NN_composition	NN_specie NN_composition
JJ_geographic NN_distribution	JJ_geographical NN_distribution
NN_specie NN_richness	NP_species NN_richness
JJ_hot NN_spot	NN_hotspot
species-level	NN_species NN_level
NN_sequence	sequenced
NN_colonization	colonisation
NN_bird NN_specie	NN_bird NN_species
JJ_climatic NN_change	NN_climate NN_change
NN_land-use NN_change	NN_land NN_use NN_change
NN_biosphere	biosphere
NN_organization	NN_organisation
NN_life NN_history	life-history
floodplains	floodplain
JJ_native NN_species	JJ_native NN_specie
effects	NN_effect
NN_crop	crops
type	NN_type
NP_novel NP_foods	NN_novel NN_food
NN_protein	protein
NN_safety NN_assessment	NP_safety NP_assessment
NN_novel CC_and JJ_familiar NN_food	NN_novel CC_or JJ_familiar NN_food
NN_bee apis mellifera	NN_bee apis mellifera NP_l
JJ_fundamental CC_and psycho-social NN_essential	JJ_fundamental CC_and JJ_psychosocial NN_essential
NN_evaluation IN_of DT_the NP_novel	NN_evaluation IN_of DT_the JJ_novel
spunta IN_with cry	spunta IN_with cry NN_v
chromatography-mass NN_spectrometry	NN_chromatography SY_/ JJ_mass NN_spectrometry
JJ_fundamental CC_and psycho-social	JJ_fundamental CC_and JJ_psychosocial
NN_calcium SY_/ potassium saltof	NN_calcium SY_/ NN_potassium NN_salt
alkaloids CC_and sesquiterpenes	alkaloids CC_and sesquiterpenes NP_on
NN_treatment IN_for non-hodgkin	NN_treatment IN_of non-hodgkin
NN_assessment IN_of NP_novel NP_foods	NN_assessment IN_of NN_novel NN_food
pyrophosphatase-based NN_detection NP_systems	pyrophosphatase-based NN_detection NP_systems .2
two-generation NN_reproduction NN_toxicity	two-generation JJ_reproductive NN_toxicity
NN_development IN_of DT_a JJ_novel	NP_development IN_of NP_novel
NP_novel NP_foods	JJ_novel NN_food
u.s. NP_food CC_and NP_drug	us NP_food CC_and NP_drug
u.s. NP_food CC_and NP_drug NP_administration	us NP_food CC_and NP_drug NP_administration
	10 NN_mg SY_/ kg
NN_p SY_< 0.05	NN_p SY_< 0.01
NN_mu NN_g SY_/ NN_g	NN_mu NN_g SY_/ kg
100 NN_mg SY_/ kg	10 NN_mg SY_/ kg
cytokines	cytokine
phosphatidylinositol-4 ,_, 5-bisphosphate	phosphatidylinositol CD_4 ,_, 5-bisphosphate
NN_cell NN_cycle NN_progression	cell-cycle NN_progression
leukocytes	leukocyte
NN_alpha NN_subunit	alpha-subunit
NN_catalyst	NN_catalysis
coactivator	co-activator
NN_antagonism	NN_antagonist
oligonucleotide	oligonucleotides
thymocyte	thymocytes
NN_carbon nanotubes	NN_carbon nanotube
phosphorylated	phosphorylates
NN_herpes JJ_simplex NN_virus	NN_herpes NN_simplex NN_virus
NN_gene IN_in drosophila	NN_gene IN_of drosophila
NN_selection NN_pressure	JJ_selective NN_pressure
JJ_reverse NN_transcriptase	NN_reverse NN_transcriptase
oscillatory	NN_oscillator
JJ_transcriptional NN_regulator	JJ_transcriptional NN_regulation
NN_regulation IN_of NN_cell	NN_regulator IN_of NN_cell
cofactors	cofactor
NN_polymerase	polymerases
JJ_thin NN_filament	JJ_thick NN_filament
active-site	JJ_active NN_site
NN_camp	camp
transduce	NN_transducer
NP_mhc NN_class NP_ii	NP_mhc NN_class NN_i
JJ_sensory NN_neurone	JJ_sensory NN_neuron
JJ_first NN_principle	first-principles
formation	NN_formation
bilayer	bilayers
NN_epitope	epitopes
JJ_consistent IN_with DT_the NN_hypothesis	JJ_consistent IN_with DT_this NN_hypothesis
mitogen	mitogens
telomeres	telomere
NN_high-resolution	JJ_high NN_resolution
neuronal NN_activity	JJ_neural NN_activity
NN_sequence	sequenced
NN_class NP_ii NN_molecule	NN_class CD_ii NN_molecule
beta-chain	JJ_beta NN_chain
beta-chain	beta-chains
beta-chain	NN_beta NN_chain
NN_gene NN_sequence	NN_genome NN_sequence
NN_electron NN_microscopy	NN_electron NN_microscope
JJ_cyclic amp	JJ_cyclic NN_amp
hybridomas	hybridoma
NN_gene IN_on NN_chromosome	NN_gene TO_to NN_chromosome
JJ_complementary NP_dna	JJ_complementary NN_dna
JJ_complementary NP_dna	JJ_complementary dnas
timescale	timescales
integrin	integrins
NN_dna NN_sequence	NP_dna NN_sequence
NN_dna NN_damage	NP_dna NN_damage
NN_influenza NN_virus	NN_influenza DT_a NN_virus
NN_cell NN_cycle NN_control	cell-cycle NN_control
JJ_amino-acid NN_sequence	NN_amino NN_acid NN_sequence
NN_tumour NN_necrosis	tumour-necrosis
germ-line	germline
NN_cell NN_surface NN_receptor	cell-surface NN_receptor
cell-surface NN_molecule	NN_cell NN_surface NN_molecule
NN_immunodeficiency NN_syndrome	JJ_immune NN_deficiency NN_syndrome
JJ_negative NN_regulation	JJ_negative NN_regulator
JJ_transcriptional NN_activator	JJ_transcriptional NN_activation
JJ_transcriptional NN_activator	JJ_transcriptional co-activator
JJ_transcriptional NN_activator	JJ_transcriptional NN_activity
NP_hiv NN_infection	hiv-1 NN_infection
NP_de novo	NP_de NP_novo
cross-linking	crosslinking
isoform	isoforms
NN_b NN_cell	NP_b NN_cell
NN_mouse JJ_embryonic NN_fibroblast	NN_mouse NN_embryo NN_fibroblast
NP_b NN_lymphocyte	NN_b NN_lymphocyte
NN_leukaemia	leukaemic
NN_leukaemia	leukaemias
JJ_solid NN_state	NN_solid-state
kilobases	kilobase
NN_loss IN_of NN_function	loss-of-function
heterodimers	heterodimer
microtubules	microtubule
JJ_steady NN_state	NN_steady-state
map	NN_map
cell-cycle NN_arrest	NN_cell NN_cycle NN_arrest
NP_north NP_america	NP_north NP_american
NN_immunoglobulin JJ_heavy NN_chain	NN_immunoglobulin heavy-chain
transgene	transgenes
nanostructures	nanostructured
tumour-suppressor	NN_tumour NN_suppressor
leukaemic NN_cell	NN_leukaemia NN_cell
hedgehog	NN_hedgehog
NN_low-density	JJ_low NN_density
NN_virus NN_infection	JJ_viral NN_infection
NN_class PP_i JJ_major histocompatibility NN_complex	NN_class NP_ii JJ_major histocompatibility NN_complex
NN_high-frequency	JJ_high NN_frequency
JJ_high NN_density	NN_high-density
NN_immunodeficiency	JJ_immune NN_deficiency
nanotube	nanotubes
NN_class NN_i	NN_class NP_i
NN_heat NN_shock	heat-shock
NN_low-frequency	JJ_low NN_frequency
zinc-finger	NN_zinc NN_finger
amp	NN_amp
JJ_light NN_chain	light-chain
JJ_light NN_chain	NN_light NN_chain
NN_structure IN_of NN_protein	NN_structure IN_of DT_a NN_protein
drosophila	NN_drosophila
neurodegenerative	neurodegeneration
proto-oncogene	proto-oncogenes
eukaryotic NN_gene	eukaryotic NN_genome
NN_dna NN_repair	NP_dna NN_repair
micrornas	microrna
NN_retinoid	retinoic
NN_class NP_i NP_mhc	NN_class NP_ii NP_mhc
JJ_acid NN_receptor	NN_acid NN_receptor
tumour-suppressor NN_gene	NN_tumour NN_suppressor NN_gene
archaea	archaean
NN_universe	universe
cytotoxic NN_t-cell	cytotoxic NN_t NN_cell
NN_structure IN_of DT_the NN_complex	NN_structure IN_of DT_a NN_complex
pre-mrna	pre-mrnas
NN_surface glycoproteins	NN_surface NN_glycoprotein
retinoic JJ_acid NN_receptor	retinoic NN_acid NN_receptor
neurite	neurites
NP_x NN_chromosome	NN_x NN_chromosome
NN_lipid bilayers	NN_lipid bilayer
NN_glycoprotein	glycoproteins
JJ_amino-acid NN_residue	NN_amino NN_acid NN_residue
JJ_amino-acid NN_substitution	NN_amino NN_acid NN_substitution
nucleosome	nucleosomes
alpha-subunits	alpha-subunit
JJ_cultured NN_cell	NN_culture NN_cell
NN_microscope	NN_microscopy
JJ_viral NN_replication	NN_virus NN_replication
NP_dna NN_replication	NN_dna NN_replication
JJ_upper NN_mantle	upper-mantle
eukaryote	eukaryotes
NN_physics	NN_physic
JJ_single NN_molecule	single-molecule
JJ_high NN_temperature	NN_high-temperature
NN_class PP_i JJ_major histocompatibility	NN_class NP_ii JJ_major histocompatibility
JJ_high NN_transition NN_temperature	high-transition-temperature
NN_messenger rnas	NN_messenger NP_rna
JJ_high NN_affinity	high-affinity
heavy-chain	JJ_heavy NN_chain
NN_support IN_of DT_this NN_hypothesis	NN_support IN_for DT_this NN_hypothesis
sh2 NN_domain	sh3 NN_domain
NN_gamma NN_delta NN_t NN_cell	NN_gamma NN_delta NN_t-cell
multi-protein NN_complex	multiprotein NN_complex
NN_common PO_' effector-processing	JJ_common NN_effector NN_processing
NN_atom IN_of DT_the ftr	NN_atom IN_in DT_the ftr
NN_polymer NN_network	JJ_polymeric NN_network
atf3 VB_be DT_a JJ_negative NN_regulator	atf3 IN_as DT_a JJ_negative NN_regulator
JJ_important NN_application	JJ_important NN_implication
gene-regulatory NN_network	NN_gene JJ_regulatory NN_network
NN_strategy IN_for DT_the JJ_total NN_synthesis	NN_strategy IN_for PP_its JJ_total NN_synthesis
JJ_negative NN_feedback NN_loop	negative-feedback NN_loop
protein-protein NN_interaction	NN_protein NN_protein NN_interaction
hydrogen-bonded NN_network	NN_hydrogen NN_bond NN_network
microarrays	microarray
JJ_neural NN_network	neuronal NN_network
NP_systems NN_biology	NN_system NN_biology
JJ_neural NN_circuit	neuronal NN_circuit
JJ_negative NN_feedback	negative-feedback
NP_systems NN_biology NN_approach	NN_system NN_biology NN_approach
NN_odour VV_learn NN_ability IN_of limax	odour-learning NN_ability IN_of limax
NN_datum NN_set	NN_data NN_set
NN_production	NN_product
NN_analysis	analysis
NN_animal	animal
NN_animal	animals
NN_subunit	NN_subunits
phosphorylating	phosphorylation
NN_genome	genome
phosphorylate	phosphorylated
phosphorylate	phosphorylates
JJ_complementary dnas	JJ_complementary NN_dna
NN_bacterium	bacteria
NN_hydrogen	hydrogel
NN_recombination	recombinational
onc NN_gene	NN_oncogene
NN_immunodeficiency	immunodeficient
JJ_transcriptional co-activator	JJ_transcriptional coactivator
JJ_transcriptional co-activator	JJ_transcriptional NN_activation
JJ_transcriptional co-activator	JJ_transcriptional NN_activity
NN_exchange	NN_exchanger
transduce	transduced
transduce	transduces
NN_dependence	NN_dependency
NN_analyst	NP_analyst
JJ_assistant	NP_assistant
NP_business NN_analyst	NP_business NP_analyst
NP_analyst	NN_analyst
NP_director NP_corporate NP_planning	NN_director IN_of NP_corporate NP_planning
NP_director NP_corporate NP_planning	NP_director IN_of NP_corporate NP_planning
NN_director IN_of NP_planning	NP_director IN_of NP_planning
NN_director	NP_director
NN_director IN_of NP_planning	NN_director IN_of NN_planning
NN_planning	NP_planning
NN_finance	NP_finance
NP_financial NP_analysis	NP_financial NN_analyst
NP_analysis	NN_analyst
NP_financial NP_analysis	NP_financial NP_analyst
NP_analyst	NP_analysis
NP_management NP_consultants	NP_management consultant
consultant	NP_consultants
NP_planning NN_analyst	NP_planning NP_analyst
JJ_senior	NP_senior
JJ_senior NP_business	NP_senior NP_business
NP_senior	JJ_senior
JJ_senior NP_business planner	NP_senior NP_business planner
JJ_senior NP_financial	JJ_senior JJ_financial
JJ_financial	NP_financial
JJ_senior NP_financial NN_analyst	JJ_senior NP_financial NP_analyst
JJ_senior NP_financial NN_analyst	NP_senior NP_financial NN_analyst
JJ_senior NP_financial NN_analyst	NP_senior NP_financial NP_analyst
JJ_senior NP_financial NN_analyst	JJ_senior JJ_financial NN_analyst
NN_acquisition	acquisitions
NN_business NN_analyst	NN_business NN_analysis
NN_analyst	NN_analysis
NN_consultant	consultant
JJ_corporate JJ_strategic	JJ_corporate NN_strategy
NN_strategy	JJ_strategic
JJ_executive	NN_executive
JJ_financial NN_analyst	JJ_financial NN_analysis
JJ_individual	NN_individual
JJ_long NN_range NN_planning	JJ_long-range NN_planning
JJ_long NN_range NN_plan	JJ_long-range NN_plan
JJ_long NN_term	JJ_long-term
JJ_operational NN_analysis	NN_operation NN_analysis
NN_accounting	NP_accounting
NN_associate	NP_associate
NN_business	NP_business
NN_business NN_analysis	NP_business NN_analyst
NN_business NN_analysis	NP_business NP_analyst
NN_business NN_analyst	NP_business NN_analyst
NP_business	NN_business
NN_business NN_analyst	NP_business NP_analyst
NN_business NN_development	NP_business NP_development
NN_business NN_planner	NP_business planner
NN_business NN_planning	NP_business NP_planning
NN_capital	NP_capital
NN_controller	controller
JJ_corporate	NP_corporate
JJ_corporate NN_development	NP_corporate NP_development
JJ_corporate NN_planner	NP_corporate planner
JJ_corporate NN_planning	NP_corporate NP_planning
NN_department	NP_department
NN_development	NP_development
NN_duty	duties
JJ_executive	NP_executive
JJ_financial NN_management	NP_financial NP_management
JJ_financial NN_planning	NP_financial NP_planning
JJ_financial NN_reporting	NP_financial NP_reporting
NN_health	NP_health
NN_health NN_care	NP_health NP_care
JJ_international	NP_international
JJ_long	NP_long
NP_long NP_range	JJ_long-range
JJ_long NN_range NN_planning	NP_long NP_range NP_planning
NN_management	NP_management
NN_manager	NP_manager
NN_market	NP_market
NN_market NN_research	NP_market NP_research
NN_marketing	NP_marketing
NN_merger	NP_mergers
JJ_new	NP_new
NN_operation	NP_operations
NN_planner	planner
NN_planning CC_and NN_analysis	NP_planning CC_and NP_analysis
NN_product	NP_product
JJ_professional	NN_professional
NP_project	NN_project
NN_research	NP_research
JJ_responsible	responsible
NN_service	NP_services
JJ_short CC_and JJ_long NN_range	JJ_short CC_and JJ_long-range
JJ_strategic	NP_strategic
JJ_strategic NN_analysis	NN_strategy NN_analysis
NN_strategy	JJ_strategic
JJ_strategic NN_planning	NP_strategic NP_planning
NN_system	NP_systems
JJ_strategic NN_planning	JJ_strategic NP_planning
JJ_strategic NN_planning	NP_strategic NN_planning
JJ_strategic NN_planning	NN_strategy NP_planning
JJ_strategic NN_planning	NN_strategy NN_planning
JJ_financial NN_analyst	NP_financial NN_analyst
JJ_financial NN_analyst	NP_financial NP_analyst
JJ_long NN_range NN_planning	JJ_long-range NP_planning
JJ_long NN_range NN_planning	JJ_long NP_range NP_planning
JJ_long NN_range NN_planning	NP_long NP_range NN_planning
JJ_long NN_range NN_planning	JJ_long NP_range NN_planning
NN_analysis	NP_analyst
NN_analysis	NP_analysis
JJ_corporate NN_planning	JJ_corporate NP_planning
JJ_corporate NN_planning	NP_corporate NN_planning
NP_long NP_range NP_planning	JJ_long-range NN_planning
NN_business NN_planning	NN_business NP_planning
NN_business NN_planning	NP_business NN_planning
JJ_financial NN_analysis	NP_financial NN_analyst
JJ_financial NN_analysis	JJ_financial NP_analyst
JJ_financial NN_analysis	JJ_financial NP_analysis
JJ_financial NN_analysis	NP_financial NP_analyst
JJ_financial NN_analysis	NP_financial NP_analysis
JJ_financial NN_analysis	NP_financial NN_analysis
JJ_financial NN_analysis	NP_financial analysis
JJ_financial NN_analysis	JJ_financial analysis
NN_market NN_research	NN_market NP_research
NN_market NN_research	NP_market NN_research
JJ_financial NN_planning	JJ_financial NP_planning
JJ_financial NN_planning	NP_financial NN_planning
NN_consultant	NP_consultants
NN_business NN_development	NN_business NP_development
NN_business NN_development	NP_business NN_development
JJ_corporate NN_development	JJ_corporate NP_development
JJ_corporate NN_development	NP_corporate NN_development
NN_business NN_analysis	NN_business NP_analyst
NN_business NN_analysis	NN_business NP_analysis
NN_business NN_analysis	NP_business NP_analysis
NN_business NN_analysis	NP_business NN_analysis
NN_business NN_analysis	NP_business analysis
NN_business NN_analysis	NN_business analysis
JJ_financial NN_reporting	JJ_financial NP_reporting
JJ_long-term	NP_long NN_term
NN_planning CC_and NN_analysis	NN_planning CC_and NP_analysis
NN_planning CC_and NN_analysis	NP_planning CC_and NN_analyst
NN_planning CC_and NN_analysis	NP_planning CC_and NP_analyst
NN_planning CC_and NN_analysis	NN_planning CC_and NN_analyst
NN_planning CC_and NN_analysis	NN_planning CC_and NP_analyst
NN_planning CC_and NN_analysis	NP_planning CC_and NN_analysis
NN_planning CC_and NN_analysis	NP_planning CC_and analysis
NN_planning CC_and NN_analysis	NN_planning CC_and analysis
NN_director IN_of NP_corporate NP_planning	NP_director IN_of NP_corporate NP_planning
JJ_operational NN_analysis	NP_operations NN_analysis
JJ_operational NN_analysis	NN_operation analysis
JJ_operational NN_analysis	NN_operation NN_analyst
JJ_operational NN_analysis	NP_operations analysis
JJ_operational NN_analysis	NP_operations NN_analyst
JJ_operational NN_analysis	NN_operation NP_analyst
JJ_operational NN_analysis	NN_operation NP_analysis
JJ_operational NN_analysis	NP_operations NP_analyst
JJ_operational NN_analysis	NP_operations NP_analysis
JJ_strategic NN_analysis	NN_strategy analysis
JJ_strategic NN_analysis	NN_strategy NN_analyst
JJ_strategic NN_analysis	JJ_strategic analysis
JJ_strategic NN_analysis	JJ_strategic NN_analyst
JJ_strategic NN_analysis	NN_strategy NP_analyst
JJ_strategic NN_analysis	NN_strategy NP_analysis
JJ_strategic NN_analysis	NP_strategic analysis
JJ_strategic NN_analysis	NP_strategic NN_analyst
JJ_strategic NN_analysis	JJ_strategic NP_analyst
JJ_strategic NN_analysis	JJ_strategic NP_analysis
JJ_strategic NN_analysis	NP_strategic NN_analysis
JJ_strategic NN_analysis	NP_strategic NP_analyst
JJ_strategic NN_analysis	NP_strategic NP_analysis
JJ_long-range	JJ_long NP_range
NP_management consultant	NN_management NP_consultants
NP_management consultant	NN_management consultant
NP_management consultant	NN_management NN_consultant
NP_management consultant	NP_management NN_consultant
JJ_financial NN_management	JJ_financial NP_management
JJ_financial NN_management	NP_financial NN_management
NP_director NP_corporate NP_planning	NN_director IN_of JJ_corporate NP_planning
NP_director NP_corporate NP_planning	NN_director IN_of NP_corporate NN_planning
NP_director NP_corporate NP_planning	NP_director IN_of JJ_corporate NP_planning
NP_director NP_corporate NP_planning	NP_director IN_of NP_corporate NN_planning
NP_director NP_corporate NP_planning	NN_director IN_of JJ_corporate NN_planning
NP_director NP_corporate NP_planning	NP_director IN_of JJ_corporate NN_planning
JJ_corporate JJ_strategic	NP_corporate NN_strategy
JJ_corporate JJ_strategic	NP_corporate JJ_strategic
JJ_corporate JJ_strategic	NP_corporate NP_strategic
JJ_corporate JJ_strategic	JJ_corporate NP_strategic
JJ_long-range NN_plan	NP_long NN_range NN_plan
JJ_senior NP_business planner	NP_senior NN_business planner
JJ_senior NP_business planner	NP_senior NP_business NN_planner
JJ_senior NP_business planner	JJ_senior NN_business planner
JJ_senior NP_business planner	NP_senior NN_business NN_planner
JJ_senior NP_business planner	JJ_senior NP_business NN_planner
JJ_senior NP_business planner	JJ_senior NN_business NN_planner
JJ_senior JJ_financial NN_analyst	JJ_senior NP_financial NP_analyst
JJ_senior JJ_financial NN_analyst	NP_senior NP_financial NN_analyst
JJ_senior JJ_financial NN_analyst	NP_senior NP_financial NP_analyst
JJ_senior JJ_financial NN_analyst	JJ_senior NP_financial NP_analysis
JJ_senior JJ_financial NN_analyst	JJ_senior NP_financial NN_analysis
JJ_senior JJ_financial NN_analyst	JJ_senior JJ_financial NP_analyst
JJ_senior JJ_financial NN_analyst	NP_senior JJ_financial NN_analyst
JJ_senior JJ_financial NN_analyst	NP_senior NP_financial NP_analysis
JJ_senior JJ_financial NN_analyst	NP_senior NP_financial NN_analysis
JJ_senior JJ_financial NN_analyst	NP_senior JJ_financial NP_analyst
JJ_senior JJ_financial NN_analyst	JJ_senior JJ_financial NP_analysis
JJ_senior JJ_financial NN_analyst	JJ_senior JJ_financial NN_analysis
JJ_senior JJ_financial NN_analyst	JJ_senior NP_financial analysis
JJ_senior JJ_financial NN_analyst	NP_senior JJ_financial NP_analysis
JJ_senior JJ_financial NN_analyst	NP_senior JJ_financial NN_analysis
JJ_senior JJ_financial NN_analyst	NP_senior NP_financial analysis
JJ_senior JJ_financial NN_analyst	JJ_senior JJ_financial analysis
JJ_senior JJ_financial NN_analyst	NP_senior JJ_financial analysis
NN_business NN_planner	NN_business planner
NN_business NN_planner	NP_business NN_planner
JJ_corporate NN_planner	JJ_corporate planner
JJ_corporate NN_planner	NP_corporate NN_planner
NN_health NN_care	NN_health NP_care
NP_planning NN_analyst	NN_planning NP_analyst
NP_planning NN_analyst	NP_planning NP_analysis
NP_planning NN_analyst	NN_planning NN_analyst
NP_planning NN_analyst	NN_planning NP_analysis
NP_planning NN_analyst	NN_planning NN_analysis
NP_planning NN_analyst	NP_planning NN_analysis
NP_planning NN_analyst	NN_planning analysis
NP_planning NN_analyst	NP_planning analysis
NN_director IN_of NN_planning	NP_director IN_of NP_planning
NN_director IN_of NN_planning	NP_director IN_of NN_planning
JJ_short CC_and JJ_long-range	JJ_short CC_and NP_long NN_range
JJ_senior NP_business	NP_senior NN_business
JJ_senior NP_business	JJ_senior NN_business
JJ_senior JJ_financial	NP_senior NP_financial
JJ_senior JJ_financial	NP_senior JJ_financial
JJ_novel	NN_novel
JJ_potential	NN_potential
NP_u.s. NP_food CC_and NP_drug NP_administration	NP_us NP_food CC_and NP_drug NP_administration
NN_food	NP_food
JJ_adverse NN_effect	JJ_adverse effects
NP_food CC_and NP_drug NP_administration	NN_food CC_and NP_drug NP_administration
NN_food CC_and NN_feed	NP_food CC_and NN_feed
NN_food NN_chain	NP_food NN_chain
NN_food NN_consumption	NP_food NN_consumption
NN_food NN_intake	NP_food NN_intake
NN_food NN_safety	NP_food NN_safety
NN_novel NN_food	JJ_novel NP_food
NN_novel NN_food	NN_novel NP_food
NN_production	NP_product
NN_strategy	NP_strategic
JJ_toxic NN_effect	JJ_toxic effects
NN_toxicity NN_study	toxicity NN_study
NP_u.s. NP_food CC_and NP_drug NP_administration	NP_us NN_food CC_and NP_drug NP_administration
NP_u.s. NP_food CC_and NP_drug NP_administration	NP_u.s. NN_food CC_and NP_drug NP_administration
JJ_total	NN_total
JJ_long NN_range	NP_long NP_range
JJ_long NN_range	JJ_long-range
NN_acquisition NN_analysis	acquisitions NN_analysis
NN_acquisition NN_analysis	NN_acquisition analysis
NN_acquisition NN_analysis	NN_acquisition NN_analyst
NN_acquisition NN_analysis	NN_acquisition NP_analyst
NN_acquisition NN_analysis	NN_acquisition NP_analysis
NN_acquisition NN_analysis	acquisitions analysis
NN_acquisition NN_analysis	acquisitions NN_analyst
NN_acquisition NN_analysis	acquisitions NP_analyst
NN_acquisition NN_analysis	acquisitions NP_analysis
NN_acquisition CC_and	acquisitions CC_and
NN_acquisition NN_study	acquisitions NN_study
NN_analysis CC_and	analysis CC_and
NN_analysis CC_and	NN_analyst CC_and
NN_analysis CC_and	NP_analyst CC_and
NN_analysis CC_and	NP_analysis CC_and
NN_analysis IN_of	analysis IN_of
NN_analysis IN_of	NN_analyst IN_of
NN_analysis IN_of	NP_analyst IN_of
NN_analysis IN_of	NP_analysis IN_of
VV_assist IN_in DT_the NN_development	VV_assist IN_in DT_the NP_development
JJ_assistant TO_to	NP_assistant TO_to
NN_business CC_and	NP_business CC_and
NN_business NN_opportunity	NP_business NN_opportunity
NP_business planner	NN_business planner
NP_business planner	NP_business NN_planner
NN_business NN_plan	NP_business NN_plan
NN_business NN_strategy	NP_business NN_strategy
NN_business NN_strategy	NN_business JJ_strategic
NN_business NN_strategy	NN_business NP_strategic
NN_business NN_strategy	NP_business JJ_strategic
NN_business NN_strategy	NP_business NP_strategic
NN_capital NN_appropriation	NP_capital NN_appropriation
NN_capital NN_expenditure	NP_capital NN_expenditure
JJ_competitive NN_analysis	JJ_competitive analysis
JJ_competitive NN_analysis	JJ_competitive NN_analyst
JJ_competitive NN_analysis	JJ_competitive NP_analyst
JJ_competitive NN_analysis	JJ_competitive NP_analysis
NN_development CC_and	NP_development CC_and
NN_development IN_of	NP_development IN_of
NN_director IN_of	NP_director IN_of
NN_director IN_of NP_planning	NP_director IN_of NN_planning
NN_duty VV_include	duties VV_include
JJ_financial CC_and	NP_financial CC_and
VV_include JJ_long NN_range	VV_include NP_long NN_range
JJ_long CC_and	NP_long CC_and
JJ_long CC_and JJ_short NN_range	NP_long CC_and JJ_short NN_range
JJ_long NN_range	JJ_long NP_range
JJ_long NN_range	NP_long NN_range
JJ_long NN_range NN_planning	NP_long NN_range NN_planning
JJ_long NN_range NN_planning	JJ_long NN_range NP_planning
JJ_long NN_range NN_planning	NP_long NN_range NP_planning
JJ_long NN_range NN_plan	NP_long NN_range NN_plan
JJ_long NN_range NN_plan	JJ_long NP_range NN_plan
JJ_long NN_range NN_plan	NP_long NP_range NN_plan
JJ_long NN_term	NP_long NN_term
NN_management CC_and	NP_management CC_and
NN_manager IN_of	NP_manager IN_of
NN_marketing CC_and	NP_marketing CC_and
NN_merger CC_and NN_acquisition	NP_mergers CC_and NN_acquisition
NN_merger CC_and NN_acquisition	NN_merger CC_and acquisitions
NN_merger CC_and NN_acquisition	NP_mergers CC_and acquisitions
JJ_new NN_business	NP_new NN_business
JJ_new NN_business	JJ_new NP_business
JJ_new NN_business	NP_new NP_business
JJ_new NN_business NN_development	NP_new NN_business NN_development
JJ_new NN_business NN_development	JJ_new NP_business NN_development
JJ_new NN_business NN_development	JJ_new NN_business NP_development
JJ_new NN_business NN_development	NP_new NP_business NN_development
JJ_new NN_business NN_development	NP_new NN_business NP_development
JJ_new NN_business NN_development	JJ_new NP_business NP_development
JJ_new NN_business NN_development	NP_new NP_business NP_development
JJ_new NN_business NN_opportunity	NP_new NN_business NN_opportunity
JJ_new NN_business NN_opportunity	JJ_new NP_business NN_opportunity
JJ_new NN_business NN_opportunity	NP_new NP_business NN_opportunity
JJ_new NN_product	NP_new NN_product
JJ_new NN_product	JJ_new NN_production
JJ_new NN_product	JJ_new NP_product
JJ_new NN_product	NP_new NN_production
JJ_new NN_product	NP_new NP_product
JJ_new NN_product NN_development	NP_new NN_product NN_development
JJ_new NN_product NN_development	JJ_new NN_production NN_development
JJ_new NN_product NN_development	JJ_new NP_product NN_development
JJ_new NN_product NN_development	JJ_new NN_product NP_development
JJ_new NN_product NN_development	NP_new NN_production NN_development
JJ_new NN_product NN_development	NP_new NP_product NN_development
JJ_new NN_product NN_development	NP_new NN_product NP_development
JJ_new NN_product NN_development	JJ_new NN_production NP_development
JJ_new NN_product NN_development	JJ_new NP_product NP_development
JJ_new NN_product NN_development	NP_new NN_production NP_development
JJ_new NN_product NN_development	NP_new NP_product NP_development
JJ_new NN_venture	NP_new NN_venture
NP_planning NP_analyst	NN_planning NP_analyst
NP_planning NP_analyst	NP_planning NP_analysis
NP_planning NP_analyst	NN_planning NN_analyst
NP_planning NP_analyst	NN_planning NP_analysis
NP_planning NP_analyst	NN_planning NN_analysis
NP_planning NP_analyst	NP_planning NN_analysis
NP_planning NP_analyst	NN_planning analysis
NP_planning NP_analyst	NP_planning analysis
NN_planning CC_and	NP_planning CC_and
NP_planning NP_manager	NN_planning NP_manager
NP_planning NP_manager	NP_planning NN_manager
NP_planning NP_manager	NN_planning NN_manager
NN_product CC_and	NN_production CC_and
NN_product CC_and	NP_product CC_and
NN_product NN_development	NN_production NN_development
NN_product NN_development	NP_product NN_development
NN_product NN_development	NN_product NP_development
NN_product NN_development	NN_production NP_development
NN_product NN_development	NP_product NP_development
NN_product NN_line	NN_production NN_line
NN_product NN_line	NP_product NN_line
NN_profit NN_planning	NN_profit NP_planning
NN_range NN_planning CC_and	NN_range NP_planning CC_and
NN_research CC_and	NP_research CC_and
JJ_responsible IN_for	responsible IN_for
JJ_responsible IN_for DT_the	responsible IN_for DT_the
JJ_senior NP_financial	NP_senior NP_financial
JJ_senior NP_financial	NP_senior JJ_financial
JJ_senior NP_financial NN_analyst	JJ_senior NP_financial NP_analysis
JJ_senior NP_financial NN_analyst	JJ_senior NP_financial NN_analysis
JJ_senior NP_financial NN_analyst	JJ_senior JJ_financial NP_analyst
JJ_senior NP_financial NN_analyst	NP_senior JJ_financial NN_analyst
JJ_senior NP_financial NN_analyst	NP_senior NP_financial NP_analysis
JJ_senior NP_financial NN_analyst	NP_senior NP_financial NN_analysis
JJ_senior NP_financial NN_analyst	NP_senior JJ_financial NP_analyst
JJ_senior NP_financial NN_analyst	JJ_senior JJ_financial NP_analysis
JJ_senior NP_financial NN_analyst	JJ_senior JJ_financial NN_analysis
JJ_senior NP_financial NN_analyst	JJ_senior NP_financial analysis
JJ_senior NP_financial NN_analyst	NP_senior JJ_financial NP_analysis
JJ_senior NP_financial NN_analyst	NP_senior JJ_financial NN_analysis
JJ_senior NP_financial NN_analyst	NP_senior NP_financial analysis
JJ_senior NP_financial NN_analyst	JJ_senior JJ_financial analysis
JJ_senior NP_financial NN_analyst	NP_senior JJ_financial analysis
JJ_senior NN_management	NP_senior NN_management
JJ_senior NN_management	JJ_senior NP_management
JJ_senior NN_management	NP_senior NP_management
JJ_short CC_and JJ_long NN_range	JJ_short CC_and NP_long NN_range
JJ_short CC_and JJ_long NN_range	JJ_short CC_and JJ_long NP_range
JJ_short CC_and JJ_long NN_range	JJ_short CC_and NP_long NP_range
JJ_short NN_range NN_planning	JJ_short NN_range NP_planning
JJ_special NN_project	JJ_special NP_project
JJ_strategic CC_and	NN_strategy CC_and
JJ_strategic CC_and	NP_strategic CC_and
JJ_strategic NN_planning CC_and	NN_strategy NN_planning CC_and
JJ_strategic NN_planning CC_and	NP_strategic NN_planning CC_and
JJ_strategic NN_planning CC_and	JJ_strategic NP_planning CC_and
JJ_strategic NN_planning CC_and	NN_strategy NP_planning CC_and
JJ_strategic NN_planning CC_and	NP_strategic NP_planning CC_and
JJ_strategic NN_plan	NN_strategy NN_plan
JJ_strategic NN_plan	NP_strategic NN_plan
NN_variance NN_analysis	NN_variance analysis
NN_variance NN_analysis	NN_variance NN_analyst
NN_variance NN_analysis	NN_variance NP_analyst
NN_variance NN_analysis	NN_variance NP_analysis
NN_effect VB_be	effects VB_be
NN_effect IN_of	effects IN_of
NN_effect IN_on	effects IN_on
NN_food CC_and	NP_food CC_and
NN_food VB_be	NP_food VB_be
NN_toxicity CC_and	toxicity CC_and
NN_toxicity IN_of	toxicity IN_of
NP_u.s. NP_food CC_and NP_drug	NP_u.s. NN_food CC_and NP_drug
NN_analysis IN_of DT_the	analysis IN_of DT_the
NN_analysis IN_of DT_the	NN_analyst IN_of DT_the
NN_analysis IN_of DT_the	NP_analyst IN_of DT_the
NN_analysis IN_of DT_the	NP_analysis IN_of DT_the
JJ_central JJ_nervous NN_system	JJ_central JJ_nervous NP_systems
NN_management IN_of	NP_management IN_of
JJ_nervous NN_system	JJ_nervous NP_systems
NN_type IN_of	type IN_of
JJ_hepatic NN_oxalate NN_production	JJ_hepatic NN_oxalate NN_product
JJ_hepatic NN_oxalate NN_production	JJ_hepatic NN_oxalate NP_product
hyperoxaluria NN_type PP_i	hyperoxaluria type PP_i
NN_kidney NN_protein	NN_kidney protein
VV_limit NN_oxalate NN_production	VV_limit NN_oxalate NN_product
VV_limit NN_oxalate NN_production	VV_limit NN_oxalate NP_product
JJ_primary hyperoxaluria NN_type	JJ_primary hyperoxaluria type
NN_production WD_that VV_lead	NN_product WD_that VV_lead
NN_production WD_that VV_lead	NP_product WD_that VV_lead
proteomic NN_analysis	proteomic analysis
proteomic NN_analysis	proteomic NN_analyst
proteomic NN_analysis	proteomic NP_analyst
proteomic NN_analysis	proteomic NP_analysis
NN_strategy TO_to VV_limit	JJ_strategic TO_to VV_limit
NN_strategy TO_to VV_limit	NP_strategic TO_to VV_limit
JJ_therapeutic NN_strategy	JJ_therapeutic JJ_strategic
JJ_therapeutic NN_strategy	JJ_therapeutic NP_strategic
NN_oxalate NN_production	NN_oxalate NN_product
NN_oxalate NN_production	NN_oxalate NP_product
NN_report	NP_report
NN_report	NP_report
JJ_antibiotic	NN_antibiotic
NN_arteritis	NN_arthritis
NN_association	NP_association
NN_cancer	NP_cancer
NP_case NP_report	NN_case NN_report
NN_center	NP_center
JJ_characteristic	NN_characteristic
JJ_clinical	clinical
JJ_complex	NN_complex
VV_compute tomographic	VV_compute NN_tomography
NN_tomography	tomographic
NP_ct NN_scan	NP_ct VV_scan
NN_scan	VV_scan
JJ_differential	NN_differential
JJ_differential NN_diagnosis	NN_differential NN_diagnosis
JJ_differential	NN_differential
NN_disease	NP_disease
NN_disease	diseases
NP_disease	diseases
NN_dna	NP_dna
eosinophilia	JJ_eosinophilic
JJ_epidemiologic	JJ_epidemiological
JJ_european	NP_european
JJ_fluid	NN_fluid
JJ_future	NN_future
NN_g	NP_g
JJ_genetic	NN_genetics
NN_group	NP_group
NN_hepatitis	NP_hepatitis
JJ_histologic NN_examination	JJ_histological NN_examination
JJ_histological	JJ_histologic
histopathologic	JJ_histopathological
histopathologic NN_examination	JJ_histopathological NN_examination
JJ_histopathological	histopathologic
NN_hospital	NP_hospital
NN_i	NP_i
JJ_internal	NN_interval
JJ_joint	NN_joint
NN_l	NP_l
JJ_large NN_b-cell NN_lymphoma	JJ_large NN_cell NN_lymphoma
NN_b-cell	NN_cell
NN_leukaemia	NN_leukemia
NN_m	NP_m
JJ_mean NN_age	VV_mean NN_age
JJ_mean	VV_mean
JJ_mean NN_follow-up	JJ_median NN_follow-up
JJ_medical	NP_medical
JJ_national	NP_national
JJ_newborn	NN_newborn
non-specific	nonspecific
NN_orphan	orphan
JJ_paediatric	JJ_pediatric
JJ_pathologic NN_finding	JJ_pathological NN_finding
JJ_pathologic	JJ_pathological
JJ_patient	NN_patient
NN_patient PO_'	NN_patient PO_'s
PO_'	PO_'s
NN_patient VV_do	NN_patient VV_die
JJ_rare	rare
JJ_rare NN_disease	rare NP_disease
JJ_rare NN_disease	rare diseases
rare NP_disease	rare diseases
diseases	NP_disease
JJ_rare NN_disease VV_characterise	JJ_rare NN_disease VV_characterize
VV_characterize	VV_characterise
JJ_reported NN_case	VV_report NN_case
JJ_reported	VV_report
VV_report DT_the NN_case	VV_report CD_two NN_case
NN_review	NP_review
NN_review IN_of DT_the NN_literature	NP_review IN_of DT_the NN_literature
NP_review	NN_review
NN_review IN_of DT_the NN_literature	VV_review DT_the NN_literature
NP_review IN_of DT_the NN_literature	VV_review DT_the NN_literature
NN_s	NP_s
JJ_standard	NN_standard
NN_study	NP_study
NN_study NN_design	NP_study NP_design
NN_syndrome	syndrome
NN_treatment	NP_treatment
NN_type NN_i	NN_type PP_i
PP_i	NN_i
JJ_variable	NN_variable
JJ_acute NN_toxicity	JJ_acute toxicity
JJ_clinical NN_trial	clinical NN_trial
NN_crop NN_plant	crops NN_plant
VV_derive NN_food CC_and NN_feed	VV_derive NP_food CC_and NN_feed
JJ_familiar NN_food	JJ_familiar NP_food
VV_feed NN_study	VV_feed NP_study
NN_feeding NN_study	NN_feeding NP_study
JJ_female NN_rat	JJ_female rats
NN_food NN_additive	NP_food NN_additive
NN_food NN_crop	NP_food NN_crop
NN_food NN_crop	NN_food crops
NN_food NN_crop	NP_food crops
NN_food VV_derive	NP_food VV_derive
NN_food NN_ingredient	NP_food NN_ingredient
NN_food NN_poisoning	NP_food NN_poisoning
NN_food NN_product	NP_food NN_product
NN_food NN_product	NN_food NN_production
NN_food NN_product	NN_food NP_product
NN_food NN_product	NP_food NN_production
NN_food NN_product	NP_food NP_product
NN_food NN_vacuole	NP_food NN_vacuole
NN_gene NN_product	NN_gene NN_production
NN_gene NN_product	NN_gene NP_product
JJ_genetic NN_engineering	NN_genetics NN_engineering
JJ_genetic NN_modification	NN_genetics NN_modification
NP_gm NN_crop	NP_gm crops
NP_gm NN_food	NP_gm NP_food
JJ_human NN_health	JJ_human NP_health
NN_lung NN_cancer	NN_lung NP_cancer
VV_modify NN_crop	VV_modify crops
VV_modify NN_food	VV_modify NP_food
NN_mu NN_g	NN_mu NP_g
NN_mu NP_m	NN_mu NN_m
NN_mu NP_m	NP_mu NP_m
JJ_oral NN_toxicity	JJ_oral toxicity
JJ_potential NN_toxicity	NN_potential NN_toxicity
JJ_potential NN_toxicity	JJ_potential toxicity
JJ_potential NN_toxicity	NN_potential toxicity
JJ_present NN_study	JJ_present NP_study
JJ_public NN_health	JJ_public NP_health
NN_rat VV_feed	rats VV_feed
NN_side NN_effect	NN_side effects
sprague-dawley NN_rat	sprague-dawley rats
NN_study VH_have	NP_study VH_have
NN_study VV_show	NP_study VV_show
NN_t NN_cell	NN_t NN_b-cell
NN_toxicity NN_study	toxicity NP_study
NN_toxicity NN_study	NN_toxicity NP_study
NN_toxicity NN_test	toxicity NN_test
JJ_unintended NN_effect	JJ_unintended effects
NN_bone NN_disease	NN_bone NP_disease
NN_bone NN_disease	NN_bone diseases
NN_case NN_report	NP_case NN_report
NN_case NN_report	NN_case NP_report
JJ_differential NN_expression	NN_differential NN_expression
gorham-stout NN_disease	gorham-stout NP_disease
gorham-stout NN_disease	gorham-stout diseases
hyperoxaluria NN_type PP_i	hyperoxaluria type NN_i
hyperoxaluria NN_type PP_i	hyperoxaluria NN_type NN_i
hyperoxaluria NN_type PP_i	hyperoxaluria type NP_i
hyperoxaluria NN_type PP_i	hyperoxaluria NN_type NP_i
JJ_orbital NN_inflammation NN_syndrome	JJ_orbital NN_inflammation syndrome
NN_patient VB_be VV_treat	JJ_patient VB_be VV_treat
JJ_rare NN_disease	JJ_rare NP_disease
JJ_rare NN_disease	rare NN_disease
JJ_rare NN_disease	JJ_rare diseases
JJ_rare NN_disease VV_characterize	rare NN_disease VV_characterise
JJ_rare NN_disease VV_characterize	JJ_rare NP_disease VV_characterise
JJ_rare NN_disease VV_characterize	JJ_rare diseases VV_characterise
JJ_rare NN_disease VV_characterize	rare NN_disease VV_characterize
JJ_rare NN_disease VV_characterize	JJ_rare NP_disease VV_characterize
JJ_rare NN_disease VV_characterize	JJ_rare diseases VV_characterize
JJ_rare NN_disease VV_characterize	rare NP_disease VV_characterise
JJ_rare NN_disease VV_characterize	rare diseases VV_characterise
JJ_rare NN_disease VV_characterize	rare NP_disease VV_characterize
JJ_rare NN_disease VV_characterize	rare diseases VV_characterize
JJ_rare NN_disease NN_pattern	rare NN_disease NN_pattern
JJ_rare NN_disease NN_pattern	JJ_rare NP_disease NN_pattern
JJ_rare NN_disease NN_pattern	JJ_rare diseases NN_pattern
JJ_rare NN_disease NN_pattern	rare NP_disease NN_pattern
JJ_rare NN_disease NN_pattern	rare diseases NN_pattern
VV_report JJ_specific NN_change	JJ_reported JJ_specific NN_change
NN_adaptor NN_protein	NN_adaptor protein
NN_amino NN_acid NN_sequence	JJ_amino-acid sequenced
NN_amino NN_acid NN_sequence	NN_amino NN_acid sequenced
NN_analysis VV_indicate	analysis VV_indicate
NN_analysis VV_indicate	NN_analyst VV_indicate
NN_analysis VV_indicate	NP_analyst VV_indicate
NN_analysis VV_indicate	NP_analysis VV_indicate
NN_analysis VV_reveal	analysis VV_reveal
NN_analysis VV_reveal	NN_analyst VV_reveal
NN_analysis VV_reveal	NP_analyst VV_reveal
NN_analysis VV_reveal	NP_analysis VV_reveal
NN_analysis VV_show	analysis VV_show
NN_analysis VV_show	NN_analyst VV_show
NN_analysis VV_show	NP_analyst VV_show
NN_analysis VV_show	NP_analysis VV_show
NN_analysis VV_suggest	analysis VV_suggest
NN_analysis VV_suggest	NN_analyst VV_suggest
NN_analysis VV_suggest	NP_analyst VV_suggest
NN_analysis VV_suggest	NP_analysis VV_suggest
NP_b NN_cell	NN_b NN_b-cell
NP_b NN_cell	NP_b NN_b-cell
JJ_binding NN_protein	JJ_binding protein
JJ_biological NN_system	JJ_biological NP_systems
NN_blot NN_analysis	NN_blot analysis
NN_blot NN_analysis	NN_blot NN_analyst
NN_blot NN_analysis	NN_blot NP_analyst
NN_blot NN_analysis	NN_blot NP_analysis
NN_breast NN_cancer	NN_breast NP_cancer
NN_cancer NN_cell	NP_cancer NN_cell
NN_cancer NN_cell	NN_cancer NN_b-cell
NN_cancer NN_cell	NP_cancer NN_b-cell
NN_case NN_study	NN_case NP_study
NN_cell NN_activation	NN_b-cell NN_activation
NN_cell NN_adhesion	NN_b-cell NN_adhesion
NN_cell MD_can	NN_b-cell MD_can
NN_cell NN_culture	NN_b-cell NN_culture
NN_cell NN_cycle	NN_b-cell NN_cycle
NN_cell NN_death	NN_b-cell NN_death
NN_cell NN_differentiation	NN_b-cell NN_differentiation
NN_cell NN_division	NN_b-cell NN_division
NN_cell VV_express	NN_b-cell VV_express
NN_cell NN_fate	NN_b-cell NN_fate
NN_cell NN_function	NN_b-cell NN_function
NN_cell NN_growth	NN_b-cell NN_growth
NN_cell VH_have	NN_b-cell VH_have
NN_cell NN_line	NN_b-cell NN_line
NN_cell NN_membrane	NN_b-cell NN_membrane
NN_cell NN_migration	NN_b-cell NN_migration
NN_cell NN_motility	NN_b-cell NN_motility
NN_cell NN_polarity	NN_b-cell NN_polarity
NN_cell NN_population	NN_b-cell NN_population
NN_cell NN_proliferation	NN_b-cell NN_proliferation
NN_cell NN_response	NN_b-cell NN_response
NN_cell NN_shape	NN_b-cell NN_shape
NN_cell VV_signal	NN_b-cell VV_signal
NN_cell NN_surface	NN_b-cell NN_surface
NN_cell NN_survival	NN_b-cell NN_survival
NN_cell NN_type	NN_b-cell NN_type
NN_cell NN_type	NN_cell type
NN_cell NN_type	NN_b-cell type
NN_cell NN_wall	NN_b-cell NN_wall
JJ_circadian NN_oscillator	JJ_circadian oscillatory
JJ_comparative NN_analysis	JJ_comparative analysis
JJ_comparative NN_analysis	JJ_comparative NN_analyst
JJ_comparative NN_analysis	JJ_comparative NP_analyst
JJ_comparative NN_analysis	JJ_comparative NP_analysis
JJ_complex NN_formation	NN_complex NN_formation
JJ_complex NN_formation	JJ_complex formation
JJ_complex NN_formation	NN_complex formation
JJ_complex NN_network	NN_complex NN_network
JJ_complex NN_system	NN_complex NN_system
JJ_complex NN_system	JJ_complex NP_systems
JJ_complex NN_system	NN_complex NP_systems
JJ_confocal NN_microscopy	JJ_confocal NN_microscope
JJ_cultured NN_cell	NN_culture NN_b-cell
JJ_cultured NN_cell	JJ_cultured NN_b-cell
NN_datum VV_demonstrate	NN_data VV_demonstrate
NN_datum VV_indicate	NN_data VV_indicate
NN_datum VV_provide	NN_data VV_provide
NN_datum VV_reveal	NN_data VV_reveal
NN_datum VV_set	NN_data VV_set
NN_datum VV_show	NN_data VV_show
NN_datum VV_suggest	NN_data VV_suggest
NN_datum VV_support	NN_data VV_support
JJ_dendritic NN_cell	JJ_dendritic NN_b-cell
JJ_different NN_type	JJ_different type
JJ_differential NN_equation	NN_differential NN_equation
NN_dna VV_bind	dna VV_bind
NN_dna VV_bind	NP_dna VV_bind
NN_dna NN_damage	dna NN_damage
NN_dna NN_replication	dna NN_replication
NN_dna NN_sequence	NP_dna sequenced
NN_dna NN_sequence	dna NN_sequence
NN_dna NN_sequence	NN_dna sequenced
NN_dna NN_sequence	dna sequenced
drosophila melanogaster	NN_drosophila melanogaster
JJ_dynamical NN_system	JJ_dynamical NP_systems
JJ_embryonic NN_stem NN_cell	JJ_embryonic NN_stem NN_b-cell
JJ_endothelial NN_cell	JJ_endothelial NN_b-cell
JJ_epithelial NN_cell	JJ_epithelial NN_b-cell
NP_es NN_cell	NP_es NN_b-cell
eukaryotic NN_cell	eukaryotic NN_b-cell
VV_examine DT_the NN_effect	VV_examine DT_the effects
NN_exchange NN_factor	NN_exchanger NN_factor
JJ_experimental NN_datum	JJ_experimental NN_data
NN_expression NN_datum	NN_expression NN_data
JJ_fluorescent NN_protein	JJ_fluorescent protein
NN_food NN_web	NP_food NN_web
NN_fusion NN_protein	NN_fusion protein
NP_g NN_alpha	NN_g NN_alpha
NP_g NN_protein	NN_g NN_protein
NP_g NN_protein	NP_g protein
NP_g NN_protein	NN_g protein
NP_g protein-coupled	NN_g protein-coupled
NN_gene NN_expression NN_datum	NN_gene NN_expression NN_data
JJ_genetic NN_analysis	NN_genetics NN_analysis
JJ_genetic NN_analysis	JJ_genetic analysis
JJ_genetic NN_analysis	JJ_genetic NN_analyst
JJ_genetic NN_analysis	JJ_genetic NP_analyst
JJ_genetic NN_analysis	JJ_genetic NP_analysis
JJ_genetic NN_analysis	NN_genetics analysis
JJ_genetic NN_analysis	NN_genetics NN_analyst
JJ_genetic NN_analysis	NN_genetics NP_analyst
JJ_genetic NN_analysis	NN_genetics NP_analysis
JJ_genetic NN_diversity	NN_genetics NN_diversity
JJ_genetic NN_diversity	JJ_genetic diversity
JJ_genetic NN_diversity	NN_genetics diversity
JJ_genetic NN_interaction	NN_genetics NN_interaction
JJ_genetic NN_network	NN_genetics NN_network
JJ_genetic JJ_regulatory NN_network	NN_genetics JJ_regulatory NN_network
JJ_genetic NN_structure	NN_genetics NN_structure
JJ_genetic NN_variation	NN_genetics NN_variation
NN_genome NN_sequence	NN_gene sequenced
NN_genome NN_sequence	genome NN_sequence
NN_genome NN_sequence	NN_genome sequenced
NN_genome NN_sequence	genome sequenced
golgi NN_complex	golgi JJ_complex
JJ_green JJ_fluorescent NN_protein	JJ_green JJ_fluorescent protein
hela NN_cell	hela NN_b-cell
NN_host NN_cell	NN_host NN_b-cell
JJ_human NN_cell	JJ_human NN_b-cell
JJ_human NN_disease	JJ_human NP_disease
JJ_human NN_disease	JJ_human diseases
JJ_human NN_genome	JJ_human genome
JJ_human NN_protein	JJ_human protein
NN_hydrogen NN_bond	hydrogel NN_bond
NN_hydrogen NN_bond NN_network	hydrogel NN_bond NN_network
NN_hydrogen VV_bond	hydrogel VV_bond
NN_hydrogen VV_bond NN_network	hydrogel VV_bond NN_network
NN_i NN_kappa	NP_i NN_kappa
NN_i NN_kappa	PP_i NN_kappa
JJ_immune NN_system	JJ_immune NP_systems
JJ_inhibitory NN_effect	JJ_inhibitory effects
JJ_integral NN_membrane NN_protein	JJ_integral NN_membrane protein
VV_interact NN_protein	VV_interact protein
NN_interaction NN_datum	NN_interaction NN_data
VV_live NN_cell	VV_live NN_b-cell
JJ_mammalian NN_cell	JJ_mammalian NN_b-cell
map NN_kinase	NN_map NN_kinase
NN_mast NN_cell	NN_mast NN_b-cell
NN_matrix NN_protein	NN_matrix protein
mdck NN_cell	mdck NN_b-cell
NN_membrane NN_protein	NN_membrane protein
microarray NN_analysis	microarrays NN_analysis
microarray NN_analysis	microarray analysis
microarray NN_analysis	microarray NN_analyst
microarray NN_analysis	microarray NP_analyst
microarray NN_analysis	microarray NP_analysis
microarray NN_analysis	microarrays analysis
microarray NN_analysis	microarrays NN_analyst
microarray NN_analysis	microarrays NP_analyst
microarray NN_analysis	microarrays NP_analysis
microarray NN_datum	microarrays NN_datum
microarray NN_datum	microarray NN_data
microarray NN_datum	microarrays NN_data
microarray NN_experiment	microarrays NN_experiment
microtubule NN_network	microtubules NN_network
JJ_mitochondrial NN_dna	JJ_mitochondrial dna
JJ_mitochondrial NN_dna	JJ_mitochondrial NP_dna
mitogen-activated NN_protein	mitogen-activated protein
mitogen-activated NN_protein NN_kinase	mitogen-activated protein NN_kinase
NN_model NN_system	NN_model NP_systems
mrna CC_and NN_protein	mrna CC_and protein
NN_muscle NN_cell	NN_muscle NN_b-cell
NN_network NN_analysis	NN_network analysis
NN_network NN_analysis	NN_network NN_analyst
NN_network NN_analysis	NN_network NP_analyst
NN_network NN_analysis	NN_network NP_analysis
NN_network NN_formation	NN_network formation
JJ_new NN_approach	NP_new NN_approach
JJ_new NN_insight	NP_new NN_insight
JJ_new NN_method	NP_new NN_method
nk NN_cell	nk NN_b-cell
NN_novel NN_mechanism	JJ_novel NN_mechanism
JJ_other NN_protein	JJ_other protein
NN_pattern NN_formation	NN_pattern formation
phosphorylation NN_site	phosphorylating NN_site
NN_precursor NN_protein	NN_precursor protein
VV_predict NN_protein	VV_predict protein
JJ_previous NN_study	JJ_previous NP_study
NN_progenitor NN_cell	NN_progenitor NN_b-cell
NN_promoter NN_region	NN_promoter region
NN_protein CD_1	protein CD_1
NN_protein MD_can	protein MD_can
NN_protein NN_complex	protein NN_complex
NN_protein NN_complex	NN_protein JJ_complex
NN_protein NN_complex	protein JJ_complex
NN_protein VV_contain	protein VV_contain
NN_protein NN_domain	protein NN_domain
NN_protein NN_expression	protein NN_expression
NN_protein NN_family	protein NN_family
NN_protein NN_folding	protein NN_folding
NN_protein NN_function	protein NN_function
NN_protein VH_have	protein VH_have
NN_protein NN_interaction	protein NN_interaction
NN_protein NN_interaction NN_network	protein NN_interaction NN_network
NN_protein VV_involve	protein VV_involve
NN_protein NN_kinase	protein NN_kinase
NN_protein NN_kinase NP_c	protein NN_kinase NP_c
NN_protein NN_level	protein NN_level
NN_protein NN_network	protein NN_network
NN_protein NN_phosphatase	protein NN_phosphatase
NN_protein NN_sequence	protein NN_sequence
NN_protein NN_sequence	NN_protein sequenced
NN_protein NN_sequence	protein sequenced
NN_protein NN_structure	protein NN_structure
NN_protein NN_synthesis	protein NN_synthesis
protein-protein NN_interaction	protein protein NN_interaction
JJ_recent NN_study	JJ_recent NP_study
JJ_recent NN_study VH_have	JJ_recent NP_study VH_have
JJ_regulatory NN_protein	JJ_regulatory protein
JJ_regulatory NN_system	JJ_regulatory NP_systems
VV_report RB_here	JJ_reported RB_here
NP_rna NN_polymerase	NP_rna polymerases
NP_s NN_phase	NN_s NN_phase
NP_s NN_phase	NP_s phase
NP_s NN_phase	NN_s phase
JJ_secretory NN_protein	JJ_secretory protein
NN_sequence NN_alignment	sequenced NN_alignment
NN_sequence NN_analysis	sequenced NN_analysis
NN_sequence NN_analysis	NN_sequence analysis
NN_sequence NN_analysis	NN_sequence NN_analyst
NN_sequence NN_analysis	NN_sequence NP_analyst
NN_sequence NN_analysis	NN_sequence NP_analysis
NN_sequence NN_analysis	sequenced analysis
NN_sequence NN_analysis	sequenced NN_analyst
NN_sequence NN_analysis	sequenced NP_analyst
NN_sequence NN_analysis	sequenced NP_analysis
NN_sequence NN_datum	sequenced NN_datum
NN_sequence NN_datum	NN_sequence NN_data
NN_sequence NN_datum	sequenced NN_data
NN_sequence NN_similarity	sequenced NN_similarity
VV_signal NN_protein	VV_signal protein
JJ_single NN_cell	JJ_single NN_b-cell
JJ_smooth NN_muscle NN_cell	JJ_smooth NN_muscle NN_b-cell
NN_stem NN_cell	NN_stem NN_b-cell
NN_study VV_demonstrate	NP_study VV_demonstrate
NN_study VH_have VV_show	NP_study VH_have VV_show
NN_study VV_indicate	NP_study VV_indicate
NN_study VV_provide	NP_study VV_provide
NN_study VV_reveal	NP_study VV_reveal
NN_study VV_suggest	NP_study VV_suggest
NN_study PP_we	NP_study PP_we
NN_system MD_can	NP_systems MD_can
NN_system VH_have	NP_systems VH_have
JJ_transcriptional NN_activation	JJ_transcriptional NN_activity
JJ_transcriptional NN_activation	JJ_transcriptional coactivator
transmembrane NN_protein	transmembrane protein
NN_tumor NN_cell	NN_tumor NN_b-cell
NN_type CD_1	type CD_1
NN_type NN_i	type PP_i
NN_type NN_i	type NN_i
NN_type NN_i	NN_type NP_i
NN_type NN_i	type NP_i
NN_type NN_i NN_collagen	type NN_i NN_collagen
NN_type NN_i NN_collagen	NN_type NP_i NN_collagen
NN_type NN_i NN_collagen	NN_type PP_i NN_collagen
NN_type NN_i NN_collagen	type NP_i NN_collagen
NN_type NN_i NN_collagen	type PP_i NN_collagen
NN_type NP_ii	type NP_ii
NN_type NP_iii	type NP_iii
NN_type NP_iv	type NP_iv
NN_tyrosine phosphorylation	NN_tyrosine phosphorylating
JJ_wild NN_type	JJ_wild type
NN_yeast NN_cell	NN_yeast NN_b-cell
NP_accounting NP_manager	NN_accounting NP_manager
NP_accounting NP_manager	NP_accounting NN_manager
NP_accounting NP_manager	NN_accounting NN_manager
NN_accounting NN_system	NP_accounting NN_system
NN_accounting NN_system	NN_accounting NP_systems
NN_accounting NN_system	NP_accounting NP_systems
NN_acquisition NN_study	acquisitions NP_study
NN_acquisition NN_study	NN_acquisition NP_study
NN_analysis CC_and JJ_special NN_project	analysis CC_and JJ_special NN_project
NN_analysis CC_and JJ_special NN_project	NN_analyst CC_and JJ_special NN_project
NN_analysis CC_and JJ_special NN_project	NP_analyst CC_and JJ_special NN_project
NN_analysis CC_and JJ_special NN_project	NP_analysis CC_and JJ_special NN_project
NN_analysis CC_and JJ_special NN_project	NN_analysis CC_and JJ_special NP_project
NN_analysis CC_and JJ_special NN_project	analysis CC_and JJ_special NP_project
NN_analysis CC_and JJ_special NN_project	NN_analyst CC_and JJ_special NP_project
NN_analysis CC_and JJ_special NN_project	NP_analyst CC_and JJ_special NP_project
NN_analysis CC_and JJ_special NN_project	NP_analysis CC_and JJ_special NP_project
NN_analysis IN_of NN_operation	analysis IN_of NN_operation
NN_analysis IN_of NN_operation	NN_analyst IN_of NN_operation
NN_analysis IN_of NN_operation	NP_analyst IN_of NN_operation
NN_analysis IN_of NN_operation	NP_analysis IN_of NN_operation
NN_analysis IN_of NN_operation	NN_analysis IN_of NP_operations
NN_analysis IN_of NN_operation	analysis IN_of NP_operations
NN_analysis IN_of NN_operation	NN_analyst IN_of NP_operations
NN_analysis IN_of NN_operation	NP_analyst IN_of NP_operations
NN_analysis IN_of NN_operation	NP_analysis IN_of NP_operations
NP_assistant NP_director	JJ_assistant NP_director
NP_assistant NP_director	NP_assistant NN_director
NP_assistant NP_director	JJ_assistant NN_director
JJ_assistant TO_to controller	NP_assistant TO_to controller
JJ_assistant TO_to controller	JJ_assistant TO_to NN_controller
JJ_assistant TO_to controller	NP_assistant TO_to NN_controller
NP_budget NP_analyst	NP_budget NN_analyst
NP_budget NP_analyst	NP_budget NP_analysis
NP_budget NP_analyst	NP_budget NN_analysis
NP_budget NP_analyst	NP_budget analysis
NN_budget NN_analysis	NN_budget analysis
NN_budget NN_analysis	NN_budget NN_analyst
NN_budget NN_analysis	NN_budget NP_analyst
NN_budget NN_analysis	NN_budget NP_analysis
NN_business VV_plan	NP_business VV_plan
NN_business NN_proposal	NP_business NN_proposal
NN_business NN_unit	NP_business NN_unit
NN_capital NN_budgeting	NP_capital NN_budgeting
NN_capital NN_budget	NP_capital NN_budget
NN_capital NN_expenditure NN_analysis	NP_capital NN_expenditure NN_analysis
NN_capital NN_expenditure NN_analysis	NN_capital NN_expenditure analysis
NN_capital NN_expenditure NN_analysis	NN_capital NN_expenditure NN_analyst
NN_capital NN_expenditure NN_analysis	NN_capital NN_expenditure NP_analyst
NN_capital NN_expenditure NN_analysis	NN_capital NN_expenditure NP_analysis
NN_capital NN_expenditure NN_analysis	NP_capital NN_expenditure analysis
NN_capital NN_expenditure NN_analysis	NP_capital NN_expenditure NN_analyst
NN_capital NN_expenditure NN_analysis	NP_capital NN_expenditure NP_analyst
NN_capital NN_expenditure NN_analysis	NP_capital NN_expenditure NP_analysis
NN_capital NN_investment	NP_capital NN_investment
NN_capital NN_project	NP_capital NN_project
NN_capital NN_project	NN_capital NP_project
NN_capital NN_project	NP_capital NP_project
NN_cash NN_management	NN_cash NP_management
NP_chief NP_financial NP_officer	NP_chief JJ_financial NP_officer
JJ_corporate NN_finance	NP_corporate NN_finance
JJ_corporate NN_finance	JJ_corporate NP_finance
JJ_corporate NN_finance	NP_corporate NP_finance
JJ_corporate NN_plan	NP_corporate NN_plan
JJ_corporate NN_strategy	NP_corporate NN_strategy
JJ_corporate NN_strategy	NP_corporate JJ_strategic
JJ_corporate NN_strategy	NP_corporate NP_strategic
JJ_corporate NN_strategy	JJ_corporate NP_strategic
NN_cost NN_analysis	NN_cost analysis
NN_cost NN_analysis	NN_cost NN_analyst
NN_cost NN_analysis	NN_cost NP_analyst
NN_cost NN_analysis	NN_cost NP_analysis
NN_datum VV_process	NN_data VV_process
VV_develop NN_business	VV_develop NP_business
VV_develop JJ_strategic NN_plan	VV_develop NN_strategy NN_plan
VV_develop JJ_strategic NN_plan	VV_develop NP_strategic NN_plan
NN_development CC_and NN_implementation	NP_development CC_and NN_implementation
NN_development NN_program	NP_development NN_program
NP_director NP_corporate NP_planning	NN_director NP_corporate NP_planning
NP_director NP_corporate NP_planning	NP_director JJ_corporate NP_planning
NP_director NP_corporate NP_planning	NP_director NP_corporate NN_planning
NP_director NP_corporate NP_planning	NN_director JJ_corporate NP_planning
NP_director NP_corporate NP_planning	NN_director NP_corporate NN_planning
NP_director NP_corporate NP_planning	NP_director JJ_corporate NN_planning
NP_director NP_corporate NP_planning	NN_director JJ_corporate NN_planning
NN_director IN_of NP_corporate	NP_director IN_of NP_corporate
NN_director IN_of NP_corporate	NN_director IN_of JJ_corporate
NN_director IN_of NP_corporate	NP_director IN_of JJ_corporate
NN_duty VV_include JJ_long NN_range NN_planning	duties VV_include JJ_long NN_range NN_planning
NN_duty VV_include JJ_long NN_range NN_planning	NN_duty VV_include NP_long NN_range NN_planning
NN_duty VV_include JJ_long NN_range NN_planning	NN_duty VV_include JJ_long NN_range NP_planning
NN_duty VV_include JJ_long NN_range NN_planning	duties VV_include NP_long NN_range NN_planning
NN_duty VV_include JJ_long NN_range NN_planning	duties VV_include JJ_long NN_range NP_planning
NN_duty VV_include JJ_long NN_range NN_planning	NN_duty VV_include NP_long NN_range NP_planning
NN_duty VV_include JJ_long NN_range NN_planning	duties VV_include NP_long NN_range NP_planning
NN_duty MD_will VV_include	duties MD_will VV_include
NN_feasibility NN_study	NN_feasibility NP_study
JJ_financial NN_control	NP_financial NN_control
JJ_financial NN_modeling	NP_financial NN_modeling
JJ_financial VV_model	NP_financial VV_model
JJ_financial NN_model	NP_financial NN_model
JJ_financial NN_operation	NP_financial NN_operation
JJ_financial NN_operation	JJ_financial NP_operations
JJ_financial NN_operation	NP_financial NP_operations
JJ_financial NN_opportunity	NP_financial NN_opportunity
JJ_financial NN_performance	NP_financial NN_performance
NP_financial planner	JJ_financial planner
NP_financial planner	NP_financial NN_planner
NP_financial planner	JJ_financial NN_planner
NP_financial NP_planning CC_and NP_analysis	JJ_financial NP_planning CC_and NP_analysis
NP_financial NP_planning CC_and NP_analysis	NP_financial NN_planning CC_and NP_analysis
NP_financial NP_planning CC_and NP_analysis	NP_financial NP_planning CC_and NN_analyst
NP_financial NP_planning CC_and NP_analysis	NP_financial NP_planning CC_and NP_analyst
NP_financial NP_planning CC_and NP_analysis	NP_financial NP_planning CC_and NN_analysis
NP_financial NP_planning CC_and NP_analysis	JJ_financial NN_planning CC_and NP_analysis
NP_financial NP_planning CC_and NP_analysis	JJ_financial NP_planning CC_and NN_analyst
NP_financial NP_planning CC_and NP_analysis	JJ_financial NP_planning CC_and NP_analyst
NP_financial NP_planning CC_and NP_analysis	JJ_financial NP_planning CC_and NN_analysis
NP_financial NP_planning CC_and NP_analysis	NP_financial NN_planning CC_and NN_analyst
NP_financial NP_planning CC_and NP_analysis	NP_financial NN_planning CC_and NP_analyst
NP_financial NP_planning CC_and NP_analysis	NP_financial NN_planning CC_and NN_analysis
NP_financial NP_planning CC_and NP_analysis	NP_financial NP_planning CC_and analysis
NP_financial NP_planning CC_and NP_analysis	JJ_financial NN_planning CC_and NN_analyst
NP_financial NP_planning CC_and NP_analysis	JJ_financial NN_planning CC_and NP_analyst
NP_financial NP_planning CC_and NP_analysis	JJ_financial NN_planning CC_and NN_analysis
NP_financial NP_planning CC_and NP_analysis	JJ_financial NP_planning CC_and analysis
NP_financial NP_planning CC_and NP_analysis	NP_financial NN_planning CC_and analysis
NP_financial NP_planning CC_and NP_analysis	JJ_financial NN_planning CC_and analysis
JJ_financial NN_plan	NP_financial NN_plan
JJ_financial NN_reporting	NP_financial NN_reporting
NP_financial NP_services	JJ_financial NP_services
NP_financial NP_services	NP_financial NN_service
NP_financial NP_services	JJ_financial NN_service
JJ_financial NN_statement	NP_financial NN_statement
JJ_financial NN_system	NP_financial NN_system
JJ_financial NN_system	JJ_financial NP_systems
JJ_financial NN_system	NP_financial NP_systems
JJ_foreign NN_exchange	JJ_foreign NN_exchanger
JJ_general NN_accounting	JJ_general NP_accounting
NN_health NN_care	NP_health NN_care
VV_include NN_analysis	VV_include analysis
VV_include NN_analysis	VV_include NN_analyst
VV_include NN_analysis	VV_include NP_analyst
VV_include NN_analysis	VV_include NP_analysis
VV_include NN_development	VV_include NP_development
VV_include NN_merger	VV_include NP_mergers
VV_include JJ_strategic NN_planning	VV_include NN_strategy NN_planning
VV_include JJ_strategic NN_planning	VV_include NP_strategic NN_planning
VV_include JJ_strategic NN_planning	VV_include JJ_strategic NP_planning
VV_include JJ_strategic NN_planning	VV_include NN_strategy NP_planning
VV_include JJ_strategic NN_planning	VV_include NP_strategic NP_planning
NN_individual MD_will	JJ_individual MD_will
NN_information NN_system	NN_information NP_systems
NN_investment NN_analysis	NN_investment analysis
NN_investment NN_analysis	NN_investment NN_analyst
NN_investment NN_analysis	NN_investment NP_analyst
NN_investment NN_analysis	NN_investment NP_analysis
JJ_joint NN_venture	NN_joint NN_venture
NP_junior NP_financial NP_analyst	NP_junior JJ_financial NP_analyst
NP_junior NP_financial NP_analyst	NP_junior NP_financial NN_analyst
NP_junior NP_financial NP_analyst	NP_junior NP_financial NP_analysis
NP_junior NP_financial NP_analyst	NP_junior NP_financial NN_analysis
NP_junior NP_financial NP_analyst	NP_junior JJ_financial NN_analyst
NP_junior NP_financial NP_analyst	NP_junior JJ_financial NP_analysis
NP_junior NP_financial NP_analyst	NP_junior JJ_financial NN_analysis
NP_junior NP_financial NP_analyst	NP_junior NP_financial analysis
NP_junior NP_financial NP_analyst	NP_junior JJ_financial analysis
JJ_long CC_and JJ_short NN_range NN_planning	NP_long CC_and JJ_short NN_range NN_planning
JJ_long CC_and JJ_short NN_range NN_planning	JJ_long CC_and JJ_short NN_range NP_planning
JJ_long CC_and JJ_short NN_range NN_planning	NP_long CC_and JJ_short NN_range NP_planning
JJ_long CC_and JJ_short NN_term	NP_long CC_and JJ_short NN_term
JJ_long NN_range NN_business	NP_long NN_range NN_business
JJ_long NN_range NN_business	JJ_long NN_range NP_business
JJ_long NN_range NN_business	NP_long NN_range NP_business
NN_management NN_decision	NP_management NN_decision
NN_management NN_function	NP_management NN_function
NN_management NN_information	NP_management NN_information
NN_management NN_team	NP_management NN_team
NP_manager NP_business NP_planning	NN_manager NP_business NP_planning
NP_manager NP_business NP_planning	NP_manager NN_business NP_planning
NP_manager NP_business NP_planning	NP_manager NP_business NN_planning
NP_manager NP_business NP_planning	NN_manager NN_business NP_planning
NP_manager NP_business NP_planning	NN_manager NP_business NN_planning
NP_manager NP_business NP_planning	NP_manager NN_business NN_planning
NP_manager NP_business NP_planning	NN_manager NN_business NN_planning
NP_manager NP_financial NP_analysis	NN_manager NP_financial NP_analysis
NP_manager NP_financial NP_analysis	NP_manager JJ_financial NP_analysis
NP_manager NP_financial NP_analysis	NP_manager NP_financial NN_analyst
NP_manager NP_financial NP_analysis	NP_manager NP_financial NP_analyst
NP_manager NP_financial NP_analysis	NP_manager NP_financial NN_analysis
NP_manager NP_financial NP_analysis	NN_manager JJ_financial NP_analysis
NP_manager NP_financial NP_analysis	NN_manager NP_financial NN_analyst
NP_manager NP_financial NP_analysis	NN_manager NP_financial NP_analyst
NP_manager NP_financial NP_analysis	NN_manager NP_financial NN_analysis
NP_manager NP_financial NP_analysis	NP_manager JJ_financial NN_analyst
NP_manager NP_financial NP_analysis	NP_manager JJ_financial NP_analyst
NP_manager NP_financial NP_analysis	NP_manager JJ_financial NN_analysis
NP_manager NP_financial NP_analysis	NP_manager NP_financial analysis
NP_manager NP_financial NP_analysis	NN_manager JJ_financial NN_analyst
NP_manager NP_financial NP_analysis	NN_manager JJ_financial NP_analyst
NP_manager NP_financial NP_analysis	NN_manager JJ_financial NN_analysis
NP_manager NP_financial NP_analysis	NN_manager NP_financial analysis
NP_manager NP_financial NP_analysis	NP_manager JJ_financial analysis
NP_manager NP_financial NP_analysis	NN_manager JJ_financial analysis
NP_manager NP_financial NP_planning	NN_manager NP_financial NP_planning
NP_manager NP_financial NP_planning	NP_manager JJ_financial NP_planning
NP_manager NP_financial NP_planning	NP_manager NP_financial NN_planning
NP_manager NP_financial NP_planning	NN_manager JJ_financial NP_planning
NP_manager NP_financial NP_planning	NN_manager NP_financial NN_planning
NP_manager NP_financial NP_planning	NP_manager JJ_financial NN_planning
NP_manager NP_financial NP_planning	NN_manager JJ_financial NN_planning
NP_manager NP_planning	NN_manager NP_planning
NP_manager NP_planning	NP_manager NN_planning
NP_manager NP_planning	NN_manager NN_planning
NN_market NN_analysis	NP_market NN_analysis
NN_market NN_analysis	NN_market analysis
NN_market NN_analysis	NN_market NN_analyst
NN_market NN_analysis	NN_market NP_analyst
NN_market NN_analysis	NN_market NP_analysis
NN_market NN_analysis	NP_market analysis
NN_market NN_analysis	NP_market NN_analyst
NN_market NN_analysis	NP_market NP_analyst
NN_market NN_analysis	NP_market NP_analysis
NP_market NP_research NP_analyst	NN_market NP_research NP_analyst
NP_market NP_research NP_analyst	NP_market NN_research NP_analyst
NP_market NP_research NP_analyst	NP_market NP_research NN_analyst
NP_market NP_research NP_analyst	NP_market NP_research NP_analysis
NP_market NP_research NP_analyst	NP_market NP_research NN_analysis
NP_market NP_research NP_analyst	NN_market NN_research NP_analyst
NP_market NP_research NP_analyst	NN_market NP_research NN_analyst
NP_market NP_research NP_analyst	NN_market NP_research NP_analysis
NP_market NP_research NP_analyst	NN_market NP_research NN_analysis
NP_market NP_research NP_analyst	NP_market NN_research NN_analyst
NP_market NP_research NP_analyst	NP_market NN_research NP_analysis
NP_market NP_research NP_analyst	NP_market NN_research NN_analysis
NP_market NP_research NP_analyst	NP_market NP_research analysis
NP_market NP_research NP_analyst	NN_market NN_research NN_analyst
NP_market NP_research NP_analyst	NN_market NN_research NP_analysis
NP_market NP_research NP_analyst	NN_market NN_research NN_analysis
NP_market NP_research NP_analyst	NN_market NP_research analysis
NP_market NP_research NP_analyst	NP_market NN_research analysis
NP_market NP_research NP_analyst	NN_market NN_research analysis
NN_marketing NN_analysis	NP_marketing NN_analysis
NN_marketing NN_analysis	NN_marketing analysis
NN_marketing NN_analysis	NN_marketing NN_analyst
NN_marketing NN_analysis	NN_marketing NP_analyst
NN_marketing NN_analysis	NN_marketing NP_analysis
NN_marketing NN_analysis	NP_marketing analysis
NN_marketing NN_analysis	NP_marketing NN_analyst
NN_marketing NN_analysis	NP_marketing NP_analyst
NN_marketing NN_analysis	NP_marketing NP_analysis
NN_marketing NN_plan	NP_marketing NN_plan
NN_marketing NN_program	NP_marketing NN_program
NN_marketing NN_strategy	NP_marketing NN_strategy
NN_marketing NN_strategy	NN_marketing JJ_strategic
NN_marketing NN_strategy	NN_marketing NP_strategic
NN_marketing NN_strategy	NP_marketing JJ_strategic
NN_marketing NN_strategy	NP_marketing NP_strategic
NN_marketing NN_study	NP_marketing NN_study
NN_marketing NN_study	NN_marketing NP_study
NN_marketing NN_study	NP_marketing NP_study
JJ_new NN_business NN_venture	NP_new NN_business NN_venture
JJ_new NN_business NN_venture	JJ_new NP_business NN_venture
JJ_new NN_business NN_venture	NP_new NP_business NN_venture
JJ_new NN_market	NP_new NN_market
JJ_new NN_market	JJ_new NP_market
JJ_new NN_market	NP_new NP_market
JJ_operational NN_analysis	JJ_operational analysis
JJ_operational NN_analysis	JJ_operational NN_analyst
JJ_operational NN_analysis	JJ_operational NP_analyst
JJ_operational NN_analysis	JJ_operational NP_analysis
JJ_operational NN_planning	JJ_operational NP_planning
NN_planning NN_activity	NP_planning NN_activity
VV_plan NN_analyst	VV_plan NP_analyst
VV_plan NN_analyst	VV_plan NP_analysis
VV_plan NN_analyst	VV_plan NN_analysis
VV_plan NN_analyst	VV_plan analysis
NN_planning CC_and NN_control	NP_planning CC_and NN_control
NN_planning CC_and NN_development	NP_planning CC_and NN_development
NN_planning CC_and NN_development	NN_planning CC_and NP_development
NN_planning CC_and NN_development	NP_planning CC_and NP_development
NN_planning CC_and NN_management	NP_planning CC_and NN_management
NN_planning CC_and NN_management	NN_planning CC_and NP_management
NN_planning CC_and NN_management	NP_planning CC_and NP_management
NN_planning CC_and JJ_special NN_project	NP_planning CC_and JJ_special NN_project
NN_planning CC_and JJ_special NN_project	NN_planning CC_and JJ_special NP_project
NN_planning CC_and JJ_special NN_project	NP_planning CC_and JJ_special NP_project
VV_plan NN_associate	VV_plan NP_associate
NP_planning NP_director	NN_planning NP_director
NP_planning NP_director	NP_planning NN_director
NP_planning NP_director	NN_planning NN_director
NN_planning NN_effort	NP_planning NN_effort
NN_planning NN_function	NP_planning NN_function
NN_planning NN_process	NP_planning NN_process
NN_planning NN_program	NP_planning NN_program
NN_planning NN_study	NP_planning NN_study
NN_planning NN_study	NN_planning NP_study
NN_planning NN_study	NP_planning NP_study
NN_planning NN_system	NP_planning NN_system
NN_planning NN_system	NN_planning NP_systems
NN_planning NN_system	NP_planning NP_systems
JJ_potential NN_acquisition	NN_potential NN_acquisition
JJ_potential NN_acquisition	JJ_potential acquisitions
JJ_potential NN_acquisition	NN_potential acquisitions
NN_product NN_analysis	NN_production NN_analysis
NN_product NN_analysis	NP_product NN_analysis
NN_product NN_analysis	NN_product analysis
NN_product NN_analysis	NN_product NN_analyst
NN_product NN_analysis	NN_product NP_analyst
NN_product NN_analysis	NN_product NP_analysis
NN_product NN_analysis	NN_production analysis
NN_product NN_analysis	NN_production NN_analyst
NN_product NN_analysis	NN_production NP_analyst
NN_product NN_analysis	NN_production NP_analysis
NN_product NN_analysis	NP_product analysis
NN_product NN_analysis	NP_product NN_analyst
NN_product NN_analysis	NP_product NP_analyst
NN_product NN_analysis	NP_product NP_analysis
NN_product CC_and NN_service	NN_production CC_and NN_service
NN_product CC_and NN_service	NP_product CC_and NN_service
NN_product CC_and NN_service	NN_product CC_and NP_services
NN_product CC_and NN_service	NN_production CC_and NP_services
NN_product CC_and NN_service	NP_product CC_and NP_services
NN_product NN_line NN_profitability	NN_production NN_line NN_profitability
NN_product NN_line NN_profitability	NP_product NN_line NN_profitability
NN_product NN_planning	NN_production NN_planning
NN_product NN_planning	NP_product NN_planning
NN_product NN_planning	NN_product NP_planning
NN_product NN_planning	NN_production NP_planning
NN_product NN_planning	NP_product NP_planning
NN_product NN_profitability	NN_production NN_profitability
NN_product NN_profitability	NP_product NN_profitability
NN_profitability NN_analysis	NN_profitability analysis
NN_profitability NN_analysis	NN_profitability NN_analyst
NN_profitability NN_analysis	NN_profitability NP_analyst
NN_profitability NN_analysis	NN_profitability NP_analysis
NN_profitability NN_study	NN_profitability NP_study
NN_project NN_management	NP_project NN_management
NN_project NN_management	NN_project NP_management
NN_project NN_management	NP_project NP_management
NN_range NN_planning	NN_range NP_planning
VV_report RB_directly	JJ_reported RB_directly
NN_research NN_study	NP_research NN_study
NN_research NN_study	NN_research NP_study
NN_research NN_study	NP_research NP_study
JJ_responsible IN_for VV_develop	responsible IN_for VV_develop
NN_sale NN_analysis	NN_sale analysis
NN_sale NN_analysis	NN_sale NN_analyst
NN_sale NN_analysis	NN_sale NP_analyst
NN_sale NN_analysis	NN_sale NP_analysis
NN_sale CC_and NN_marketing	NN_sale CC_and NP_marketing
JJ_senior NN_analyst	NP_senior NN_analyst
JJ_senior NN_analyst	JJ_senior NP_analyst
JJ_senior NN_analyst	JJ_senior NP_analysis
JJ_senior NN_analyst	JJ_senior NN_analysis
JJ_senior NN_analyst	NP_senior NP_analyst
JJ_senior NN_analyst	NP_senior NP_analysis
JJ_senior NN_analyst	NP_senior NN_analysis
JJ_senior NN_analyst	JJ_senior analysis
JJ_senior NN_analyst	NP_senior analysis
JJ_senior NP_business NN_analyst	NP_senior NP_business NN_analyst
JJ_senior NP_business NN_analyst	JJ_senior NN_business NN_analyst
JJ_senior NP_business NN_analyst	JJ_senior NP_business NP_analyst
JJ_senior NP_business NN_analyst	JJ_senior NP_business NP_analysis
JJ_senior NP_business NN_analyst	JJ_senior NP_business NN_analysis
JJ_senior NP_business NN_analyst	NP_senior NN_business NN_analyst
JJ_senior NP_business NN_analyst	NP_senior NP_business NP_analyst
JJ_senior NP_business NN_analyst	NP_senior NP_business NP_analysis
JJ_senior NP_business NN_analyst	NP_senior NP_business NN_analysis
JJ_senior NP_business NN_analyst	JJ_senior NN_business NP_analyst
JJ_senior NP_business NN_analyst	JJ_senior NN_business NP_analysis
JJ_senior NP_business NN_analyst	JJ_senior NN_business NN_analysis
JJ_senior NP_business NN_analyst	JJ_senior NP_business analysis
JJ_senior NP_business NN_analyst	NP_senior NN_business NP_analyst
JJ_senior NP_business NN_analyst	NP_senior NN_business NP_analysis
JJ_senior NP_business NN_analyst	NP_senior NN_business NN_analysis
JJ_senior NP_business NN_analyst	NP_senior NP_business analysis
JJ_senior NP_business NN_analyst	JJ_senior NN_business analysis
JJ_senior NP_business NN_analyst	NP_senior NN_business analysis
JJ_senior NP_planning	NP_senior NP_planning
JJ_senior NP_planning	JJ_senior NN_planning
JJ_senior NP_planning	NP_senior NN_planning
JJ_short CC_and JJ_long NN_range NN_planning	JJ_short CC_and NP_long NN_range NN_planning
JJ_short CC_and JJ_long NN_range NN_planning	JJ_short CC_and JJ_long NN_range NP_planning
JJ_short CC_and JJ_long NN_range NN_planning	JJ_short CC_and NP_long NN_range NP_planning
JJ_short CC_and JJ_long NN_range NN_plan	JJ_short CC_and NP_long NN_range NN_plan
JJ_short CC_and JJ_long NN_term	JJ_short CC_and NP_long NN_term
JJ_special NN_study	JJ_special NP_study
NN_statement NN_analysis	NN_statement analysis
NN_statement NN_analysis	NN_statement NN_analyst
NN_statement NN_analysis	NN_statement NP_analyst
NN_statement NN_analysis	NN_statement NP_analysis
JJ_strategic NN_business	NN_strategy NN_business
JJ_strategic NN_business	NP_strategic NN_business
JJ_strategic NN_business	JJ_strategic NP_business
JJ_strategic NN_business	NN_strategy NP_business
JJ_strategic NN_business	NP_strategic NP_business
JJ_strategic NN_business NN_plan	NN_strategy NN_business NN_plan
JJ_strategic NN_business NN_plan	NP_strategic NN_business NN_plan
JJ_strategic NN_business NN_plan	JJ_strategic NP_business NN_plan
JJ_strategic NN_business NN_plan	NN_strategy NP_business NN_plan
JJ_strategic NN_business NN_plan	NP_strategic NP_business NN_plan
NP_strategic planner	JJ_strategic planner
NP_strategic planner	NN_strategy planner
NP_strategic planner	NP_strategic NN_planner
NP_strategic planner	JJ_strategic NN_planner
NP_strategic planner	NN_strategy NN_planner
JJ_strategic VV_plan	NN_strategy VV_plan
JJ_strategic VV_plan	NP_strategic VV_plan
NP_strategic NP_planning NP_analyst	JJ_strategic NP_planning NP_analyst
NP_strategic NP_planning NP_analyst	NN_strategy NP_planning NP_analyst
NP_strategic NP_planning NP_analyst	NP_strategic NN_planning NP_analyst
NP_strategic NP_planning NP_analyst	NP_strategic NP_planning NN_analyst
NP_strategic NP_planning NP_analyst	NP_strategic NP_planning NP_analysis
NP_strategic NP_planning NP_analyst	NP_strategic NP_planning NN_analysis
NP_strategic NP_planning NP_analyst	JJ_strategic NN_planning NP_analyst
NP_strategic NP_planning NP_analyst	JJ_strategic NP_planning NN_analyst
NP_strategic NP_planning NP_analyst	JJ_strategic NP_planning NP_analysis
NP_strategic NP_planning NP_analyst	JJ_strategic NP_planning NN_analysis
NP_strategic NP_planning NP_analyst	NN_strategy NN_planning NP_analyst
NP_strategic NP_planning NP_analyst	NN_strategy NP_planning NN_analyst
NP_strategic NP_planning NP_analyst	NN_strategy NP_planning NP_analysis
NP_strategic NP_planning NP_analyst	NN_strategy NP_planning NN_analysis
NP_strategic NP_planning NP_analyst	NP_strategic NN_planning NN_analyst
NP_strategic NP_planning NP_analyst	NP_strategic NN_planning NP_analysis
NP_strategic NP_planning NP_analyst	NP_strategic NN_planning NN_analysis
NP_strategic NP_planning NP_analyst	NP_strategic NP_planning analysis
NP_strategic NP_planning NP_analyst	JJ_strategic NN_planning NN_analyst
NP_strategic NP_planning NP_analyst	JJ_strategic NN_planning NP_analysis
NP_strategic NP_planning NP_analyst	JJ_strategic NN_planning NN_analysis
NP_strategic NP_planning NP_analyst	JJ_strategic NP_planning analysis
NP_strategic NP_planning NP_analyst	NN_strategy NN_planning NN_analyst
NP_strategic NP_planning NP_analyst	NN_strategy NN_planning NP_analysis
NP_strategic NP_planning NP_analyst	NN_strategy NN_planning NN_analysis
NP_strategic NP_planning NP_analyst	NN_strategy NP_planning analysis
NP_strategic NP_planning NP_analyst	NP_strategic NN_planning analysis
NP_strategic NP_planning NP_analyst	JJ_strategic NN_planning analysis
NP_strategic NP_planning NP_analyst	NN_strategy NN_planning analysis
JJ_strategic NN_planning NN_process	NN_strategy NN_planning NN_process
JJ_strategic NN_planning NN_process	NP_strategic NN_planning NN_process
JJ_strategic NN_planning NN_process	JJ_strategic NP_planning NN_process
JJ_strategic NN_planning NN_process	NN_strategy NP_planning NN_process
JJ_strategic NN_planning NN_process	NP_strategic NP_planning NN_process
NN_strategy NN_development	JJ_strategic NN_development
NN_strategy NN_development	NP_strategic NN_development
NN_strategy NN_development	NN_strategy NP_development
NN_strategy NN_development	JJ_strategic NP_development
NN_strategy NN_development	NP_strategic NP_development
NN_term NN_planning	NN_term NP_planning
JJ_top NN_management	JJ_top NP_management
NN_trend NN_analysis	NN_trend analysis
NN_trend NN_analysis	NN_trend NN_analyst
NN_trend NN_analysis	NN_trend NP_analyst
NN_trend NN_analysis	NN_trend NP_analysis
NN_venture NN_analysis	NN_venture analysis
NN_venture NN_analysis	NN_venture NN_analyst
NN_venture NN_analysis	NN_venture NP_analyst
NN_venture NN_analysis	NN_venture NP_analysis
NN_accounting	NN_accountant
NN_administration	JJ_administrative
NN_analysis	JJ_analytical
NP_budget	NN_budget
NP_budget	NN_budgeting
NN_business NN_plan	NN_business NN_planner
NN_business NN_plan	NP_business planner
NN_business NN_plan	NN_business planner
NN_business NN_plan	NP_business NN_planner
NN_business NN_plan	NN_business NN_planning
NN_business NN_plan	NP_business NP_planning
NN_business NN_plan	NN_business NP_planning
NN_business NN_plan	NP_business NN_planning
NN_business NN_plan	NN_business VV_plan
NN_business NN_plan	NP_business VV_plan
NN_consultant	NN_consulting
NN_controller	NN_control
NN_director	NN_direction
NN_division	JJ_divisional
NN_duty MD_will VV_include	NN_duty VV_include JJ_long NN_range NN_planning
NN_duty MD_will VV_include	duties VV_include JJ_long NN_range NN_planning
NN_duty MD_will VV_include	NN_duty VV_include NP_long NN_range NN_planning
NN_duty MD_will VV_include	NN_duty VV_include JJ_long NN_range NP_planning
NN_duty MD_will VV_include	duties VV_include NP_long NN_range NN_planning
NN_duty MD_will VV_include	duties VV_include JJ_long NN_range NP_planning
NN_duty MD_will VV_include	NN_duty VV_include NP_long NN_range NP_planning
NN_duty MD_will VV_include	duties VV_include NP_long NN_range NP_planning
JJ_financial NN_modeling	NP_financial VV_model
NP_financial planner	JJ_financial NN_planning
NP_financial planner	NP_financial NP_planning
NP_financial planner	JJ_financial NP_planning
NP_financial planner	NP_financial NN_planning
NN_forecasting	NN_forecast
JJ_long CC_and JJ_short NN_range	JJ_long CC_and JJ_short NN_range NN_planning
JJ_long CC_and JJ_short NN_range	NP_long CC_and JJ_short NN_range NN_planning
JJ_long CC_and JJ_short NN_range	JJ_long CC_and JJ_short NN_range NP_planning
JJ_long CC_and JJ_short NN_range	NP_long CC_and JJ_short NN_range NP_planning
JJ_long NN_range NN_plan	JJ_long NN_range
JJ_long NN_range NN_plan	NP_long NP_range
JJ_long NN_range NN_plan	JJ_long-range
JJ_long NN_range NN_plan	JJ_long NP_range
JJ_long NN_range NN_plan	NP_long NN_range
JJ_long NN_range NN_plan	JJ_long NN_range NN_planning
JJ_long NN_range NN_plan	JJ_long-range NN_planning
JJ_long NN_range NN_plan	NP_long NP_range NP_planning
JJ_long NN_range NN_plan	JJ_long-range NP_planning
JJ_long NN_range NN_plan	JJ_long NP_range NP_planning
JJ_long NN_range NN_plan	NP_long NP_range NN_planning
JJ_long NN_range NN_plan	JJ_long NP_range NN_planning
JJ_long NN_range NN_plan	NP_long NN_range NN_planning
JJ_long NN_range NN_plan	JJ_long NN_range NP_planning
JJ_long NN_range NN_plan	NP_long NN_range NP_planning
VV_operate NN_plan	JJ_operational NN_planning
VV_operate NN_plan	JJ_operational NP_planning
NP_planning NN_analyst	VV_plan NP_analyst
NP_planning NN_analyst	VV_plan NP_analysis
NP_planning NN_analyst	VV_plan NN_analysis
NP_planning NN_analyst	VV_plan analysis
NN_profit NN_planning	NN_profit NN_plan
NN_plan	NP_planning
NN_plan	VV_plan
NN_plan	NN_planning
NN_report	NN_reporting
NN_responsibility	JJ_responsible
NN_responsibility	responsible
short-long NN_range	JJ_short CC_and JJ_long NN_range
short-long NN_range	JJ_short CC_and JJ_long-range
short-long NN_range	JJ_short CC_and NP_long NN_range
short-long NN_range	JJ_short CC_and JJ_long NP_range
short-long NN_range	JJ_short CC_and NP_long NP_range
JJ_short NN_term	JJ_short NN_term
JJ_strategic NN_planning	NN_strategy VV_plan
JJ_strategic NN_planning	NP_strategic VV_plan
JJ_technical	NN_technique
NP_vice NP_president	NP_vp
JJ_active	NN_activity
NN_addition	JJ_additional
NN_allergen	allergenicity
NN_animal	JJ_animal
NN_contaminant	NN_contamination
NN_development	JJ_developmental
NN_diet	JJ_dietary
NN_difference	JJ_different
JJ_effective	NN_efficacy
JJ_effective	NN_efficiency
JJ_environmental	NN_environment
NN_experiment	JJ_experimental
NN_feed	NN_feeding
JJ_female	NN_female
JJ_high NN_concentration	JJ_high NN_dose
JJ_high NN_concentration	NN_high-dose
JJ_human	NN_human
JJ_industrial	NN_industry
NN_inhibition	NN_inhibitor
NN_modification	JJ_modified
JJ_molecular	NN_molecule
NN_regulation	JJ_regulatory
NN_safety	JJ_safe
NN_sensitivity	JJ_sensitive
JJ_substantial NN_equivalence	NN_substance NN_equivalence
NN_synthesis	JJ_synthetic
NN_test	NN_testing
JJ_therapeutic	NN_therapy
NN_toxicology	JJ_toxicological
vitro	JJ_vitro
JJ_vivo	vivo
NP_executive	NN_executive
NP_financial NP_analysis	JJ_financial NN_analyst
NP_financial NN_analyst	NP_financial NP_analyst
JJ_senior NP_financial NP_analyst	NP_senior NP_financial NP_analyst
NP_executive	NN_executive
NP_financial NP_analysis	JJ_financial NN_analyst
NP_financial NN_analyst	NP_financial NP_analyst
JJ_senior NP_financial NP_analyst	NP_senior NP_financial NP_analyst
NN_adapter NN_protein	NN_adaptor NN_protein
JJ_adult	NN_adult
JJ_aggregate	NN_aggregate
JJ_alternative VV_splice	NN_alternative VV_splice
NN_amino NN_acid	JJ_amino-acid
NN_angstrom NN_resolution	angstrom NN_resolution
arabidopsis thaliana	arabidopsis-thaliana
JJ_associated	NN_associate
NP_atp	atp
JJ_average	NN_average
NN_bacillus NN_subtili	bacillus-subtilis
JJ_beta NN_cell	beta-cells
JJ_binding	binding
JJ_binding NN_domain	VV_bind NN_domain
JJ_binding NN_protein	VV_bind NN_protein
JJ_binding NN_protein	binding-protein
VV_bind NN_protein	binding-protein
JJ_binding NN_site	binding-sites
VV_bind NN_site	binding-sites
NN_biology	biology
brefeldin NP_a	brefeldin-a
JJ_budding NN_yeast	VV_bud NN_yeast
JJ_budding	VV_bud
caenorhabditis elegans	caenorhabditis-elegans
JJ_camp	NN_camp
JJ_camp	camp
JJ_canine NN_kidney NN_cell	JJ_canine kidney-cells
JJ_central JJ_nervous NN_system	central-nervous-system
chemokine	chemokines
NN_class NN_i	NN_class NP_ii
NP_ii	NN_i
NN_clock	NP_clock
co-expressed	coexpressed
co-expression	coexpression
VV_coil NN_coil	coiled-coil
JJ_complex	complex
NN_complex	complex
JJ_computational	computationally
JJ_computational NN_model	JJ_computational NN_modeling
NN_model	NN_modeling
JJ_connective NN_tissue	connective tissue
JJ_connective NN_tissue	connective-tissue
connective tissue	connective-tissue
NN_control	NP_control
NN_control NN_cell	VV_control NN_cell
VV_control	NN_control
JJ_core NN_protein	NN_core NN_protein
NN_crystal NN_structure	crystal-structure
JJ_crystallographic	NN_crystallography
NN_cytochrome SY_b	NN_cytochrome SY_c
NN_data	NP_data
NN_datum	NP_data
NN_data NN_set	NN_datum VV_set
NN_database	database
JJ_difficult	NN_difficulty
NP_dna	dna
NN_dna NN_damage	dna-damage
NP_dna NN_damage	dna-damage
NN_domain	domain
down-regulation	downregulation
NN_drosophila NN_embryo	drosophila NN_embryo
drosophila melanogaster	drosophila-melanogaster
JJ_dynamic	NP_dynamics
JJ_dynamic NN_behavior	JJ_dynamical NN_behavior
JJ_dynamical	JJ_dynamic
JJ_dynamic NN_property	JJ_dynamical NN_property
JJ_dynamical	JJ_dynamic
JJ_dynamic NN_system	JJ_dynamical NN_system
JJ_dynamical	JJ_dynamic
NN_dynamics	NP_dynamics
NN_electron NN_microscopy	electron-microscopy
JJ_embryonic NN_stem NN_cell	JJ_embryonic stem-cells
JJ_endoplasmic NN_reticulum	endoplasmic-reticulum
JJ_endothelial NN_cell	endothelial-cells
JJ_epidermal NN_growth NN_factor	JJ_epidermal growth-factor
epithelia	JJ_epithelial
JJ_epithelial NN_cell	epithelial-cells
JJ_extracellular NN_matrix	extracellular-matrix
NN_factor	NP_factor
NN_factor VV_bind	factor-binding
NN_feedback NN_inhibition	feedback inhibition
NN_feedback NN_inhibition	NN_feedback NN_inhibitor
feedback inhibition	NN_feedback NN_inhibitor
NN_feedback NN_regulation	NN_feedback NN_regulator
NN_regulator	NN_regulation
NN_feedback NN_regulation	feedback-regulation
JJ_filamentous NN_network	NN_filament NN_network
JJ_filamentous	NN_filament
JJ_functional genomic	JJ_functional genomics
NP_g NN_protein	g-protein
NP_g protein-coupled NN_receptor	g-protein-coupled NN_receptor
NN_gene NN_expression NN_datum	gene-expression NN_datum
NN_gene NN_expression NN_profile	NN_gene NN_expression VV_profil
VV_profil	NN_profile
NN_gene NN_expression NN_profile	gene-expression NN_profile
NN_gene NN_ontology	NP_gene ontology
JJ_general	NN_general
JJ_genetic NN_analysis	genomic NN_analysis
genomic	JJ_genetic
NN_genome NN_sequence	genomic NN_sequence
genomic	NN_genome
NN_growth	NP_growth
NN_growth NN_factor	growth-factor
NN_growth NN_factor NN_receptor	growth-factor NN_receptor
NN_growth factor-beta	growth-factor-beta
haplotype	haplotypes
hepatocyte	hepatocytes
JJ_hybrid	NN_hybrid
NN_hydrogen VV_bond	hydrogen-bonding
NN_hydrogen VV_bond NN_network	hydrogen-bonding NN_network
NN_inhibition	inhibition
VV_interact NN_partner	NN_interaction NN_partner
VV_interact	NN_interaction
NP_interaction	NN_interaction
NP_iv	iv
NN_kidney NN_cell	kidney-cells
NN_kinase	kinase
JJ_knock-out	NN_knockout
JJ_large NN_scale	JJ_large-scale
JJ_latter	NN_latter
NN_ligand VV_bind	ligand-binding
JJ_mammalian NN_cell	mammalian-cells
JJ_mass NN_spectrometry	NN_mass NN_spectrometry
JJ_mass NN_spectrometry	mass-spectrometry
JJ_mathematical NN_modeling	JJ_mathematical VV_model
NN_matrix	matrix
NN_matrix metalloproteinase	NN_matrix metalloproteinases
metalloproteinases	metalloproteinase
JJ_maximum	NN_maximum
NN_membrane	membrane
NN_membrane NN_protein	membrane-protein
NN_membrane NN_protein	membrane-proteins
membrane-protein	membrane-proteins
NN_messenger NP_rna	messenger-rna
metalloproteinase	metalloproteinases
JJ_mitochondrial NN_dna	mitochondrial-dna
NN_model	NP_model
JJ_molecular NN_dynamics	molecular-dynamics
NN_monoclonal NN_antibody	monoclonal-antibodies
JJ_negative NN_feedback NN_regulation	JJ_negative NN_feedback NN_regulator
NN_regulator	NN_regulation
JJ_nervous NN_system	NN_nervous-system
NN_network VV_base	JJ_network-based
NN_network IN_of VV_interact	NN_network IN_of NN_interaction
VV_interact	NN_interaction
JJ_neural	neural
JJ_neural NN_network	neural NP_networks
JJ_neural NN_network	neural-networks
neural NP_networks	neural-networks
JJ_neutrophil	NN_neutrophil
nf NN_kappa	nf-kappa
nf-kappa	nf-kappab
nf-kappa NP_b	nf-kappa-b
nf-kappa NP_b	nf-kappab
nf-kappa-b	nf-kappab
JJ_nitric NN_oxide	nitric-oxide
NP_nmr	nmr
non-linear	JJ_nonlinear
JJ_nutrient	NN_nutrient
NN_ontology	ontology
ortholog	orthologs
JJ_parallel	NN_parallel
NN_pathway	pathway
NN_plasma NN_membrane	plasma-membrane
JJ_positive	NN_positive
post-translational	posttranslational
post-translational NN_modification	posttranslational NN_modification
post-translational	posttranslational
NN_power NN_law	power-law
JJ_present	NN_present
NN_protein	proteins
protein	proteins
NN_protein CD_1	protein-1
NN_protein VV_interact	NN_protein NN_interaction
VV_interact	NN_interaction
NN_protein NN_interaction	protein-interaction
NN_protein NN_interaction NN_network	protein-interaction NN_network
NN_protein NN_kinase	protein-kinase
NN_protein NN_kinase NP_a	NN_protein NN_kinase NP_c
NN_protein NN_kinase NP_c	protein-kinase-c
protein-kinase	protein-kinase-c
proteoglycan	proteoglycans
proteomic	proteomics
NN_q	NP_q
NP_ras	ras
NN_rat	rat
NN_rat NN_liver	rat-liver
JJ_real NN_time	JJ_real-time
NN_receptor	receptor
NN_regulator	NP_regulatory
JJ_regulatory	NP_regulatory
NN_rho	NP_rho
NP_rna	rna
NN_role	role
schizosaccharomyces NN_pombe	schizosaccharomyces-pombe
NN_sea	NP_sea
NN_side NN_chain	side-chain
side-chain	side-chains
NN_signal NN_transduction	signal-transduction
JJ_skeletal NN_muscle	skeletal-muscle
JJ_small gtpase	JJ_small gtpases
gtpases	gtpase
JJ_smooth NN_muscle	smooth-muscle
JJ_smooth NN_muscle NN_cell	smooth-muscle NN_cell
spatio-temporal	JJ_spatiotemporal
NN_spectra	JJ_spectral
NN_stem NN_cell	VV_stem NN_cell
NN_stem	VV_stem
NN_stem NN_cell	stem-cells
VV_stem NN_cell	stem-cells
NN_structure	structure
NN_structure	JJ_structured
structure	JJ_structured
JJ_subject	NN_subject
NN_system	NP_system
NN_system NN_biology	NP_systems biology
JJ_terminal	NN_terminal
VV_test DT_the NN_hypothesis	VV_test DT_this NN_hypothesis
NN_time NN_series	time-series
NN_tissue	tissue
NP_tnf NN_alpha	tnf-alpha
NP_trans golgi	trans-golgi
NP_trans golgi NN_network	trans-golgi NN_network
NP_trans golgi NN_network	trans-golgi NP_network
trans-golgi NN_network	trans-golgi NP_network
NN_transcription NN_network	JJ_transcriptional NN_network
NN_transcription NN_regulation	JJ_transcriptional NN_regulation
NN_tumor NN_necrosis NN_factor	tumor-necrosis-factor
NN_tumor NN_suppressor	JJ_tumor-suppressor
NN_type NP_i	NN_type PP_i
PP_i	NP_i
JJ_visual NN_cortex	visual-cortex
NN_web	NP_web
JJ_whole NN_genome	whole-genome
JJ_wild NN_type	wildtype
wild-type	wildtype
NN_x	NP_x
NN_y	NP_y
NN_yeast saccharomyces cerevisiae	NN_yeast saccharomyces-cerevisiae
NN_gene	NN_genetics
NN_gene	genomic
NN_gene	genomics
NN_gene	NN_genome
NN_gene	genome
NN_model	VV_model
NP_interaction	VV_interact
NN_control	controller
inhibition	NN_inhibitor
inhibition	JJ_inhibitory
NN_i	ii
NN_i	NP_iii
NN_i	iii
NN_protein NN_kinase	protein-kinase-c
NN_protein NN_kinase	NN_protein NN_kinase NP_c
NN_protein NN_kinase	protein NN_kinase NP_c
NN_protein NN_kinase	NN_protein NN_kinase NP_a
NN_messenger NP_rna	mrna
NN_messenger NP_rna	mrnas
NN_transcription NN_regulation	JJ_transcriptional NN_regulator
NN_gene JJ_regulatory NN_network	NN_genetics JJ_regulatory NN_network
NN_protein VV_interact	protein NN_interaction
NN_protein VV_interact	protein-interaction
JJ_associated	NP_associate
NN_datum NN_set	NN_data VV_set
nf NN_kappa	nf-kappab
nf NN_kappa	nf-kappa NP_b
nf NN_kappa	nf-kappa-b
NN_hydrogen NN_bond NN_network	hydrogel VV_bond NN_network
NN_hydrogen NN_bond NN_network	hydrogen-bonding NN_network
NN_direction	NP_director
NN_side NN_chain	side-chains
JJ_dynamic NN_system	JJ_dynamical NP_systems
JJ_long-range	NP_long NN_range
JJ_long-range	JJ_long-range NN_plan
JJ_long-range	NP_long NN_range NN_plan
JJ_long-range	JJ_long NP_range NN_plan
JJ_long-range	NP_long NP_range NN_plan
JJ_long-range	JJ_long NN_range NN_planning
JJ_long-range	JJ_long-range NN_planning
JJ_long-range	NP_long NP_range NP_planning
JJ_long-range	JJ_long-range NP_planning
JJ_long-range	JJ_long NP_range NP_planning
JJ_long-range	NP_long NP_range NN_planning
JJ_long-range	JJ_long NP_range NN_planning
JJ_long-range	NP_long NN_range NN_planning
JJ_long-range	JJ_long NN_range NP_planning
JJ_long-range	NP_long NN_range NP_planning
NN_leukemia	leukaemic
NN_leukemia	leukaemias
NN_adapter NN_protein	NN_adaptor protein
NN_transducer	transduced
NN_transducer	transduces
il-6	il-10
il-6	il-1
il-6	il-3
il-6	il-8
il-6	il-12
il-6	NN_il-4
il-6	il-2
il-6	il-4
il-6	il-5
il-6	il-7
il-6	il-11
il-6	il-9
NN_support NN_vector NN_machine	svm
NP_alzheimer	alzheimers-disease
NN_regulation	NP_regulatory
NN_inhibition	JJ_inhibitory
NP_iii	PP_i
NP_iii	ii
NP_iii	NP_i
